安徽省安庆市大观区人民法院	安徽
安徽省安庆市宜秀区人民法院	安徽
安徽省安庆市迎江区人民法院	安徽
安徽省安庆市中级人民法院	安徽
安徽省蚌埠市蚌山区人民法院	安徽
安徽省蚌埠市淮上区人民法院	安徽
安徽省蚌埠市龙子湖区人民法院	安徽
安徽省蚌埠市禹会区人民法院	安徽
安徽省蚌埠市中级人民法院	安徽
安徽省亳州市谯城区人民法院	安徽
安徽省亳州市中级人民法院	安徽
安徽省巢湖市人民法院	安徽
安徽省池州市贵池区人民法院	安徽
安徽省池州市中级人民法院	安徽
安徽省滁州市琅琊区人民法院	安徽
安徽省滁州市南谯区人民法院	安徽
安徽省滁州市中级人民法院	安徽
安徽省枞阳县人民法院	安徽
安徽省当涂县人民法院	安徽
安徽省砀山县人民法院	安徽
安徽省定远县人民法院	安徽
安徽省东至县人民法院	安徽
安徽省繁昌县人民法院	安徽
安徽省肥东县人民法院	安徽
安徽省肥西县人民法院	安徽
安徽省凤台县人民法院	安徽
安徽省凤阳县人民法院	安徽
安徽省阜南县人民法院	安徽
安徽省阜阳市颍东区人民法院	安徽
安徽省阜阳市颍泉区人民法院	安徽
安徽省阜阳市颍州区人民法院	安徽
安徽省阜阳市中级人民法院	安徽
安徽省高级人民法院	安徽
安徽省固镇县人民法院	安徽
安徽省广德县人民法院	安徽
安徽省含山县人民法院	安徽
安徽省合肥高新技术产业开发区人民法院	安徽
安徽省合肥市包河区人民法院	安徽
安徽省合肥市庐阳区人民法院	安徽
安徽省合肥市蜀山区人民法院	安徽
安徽省合肥市瑶海区人民法院	安徽
安徽省合肥市中级人民法院	安徽
安徽省合肥铁路运输法院	安徽
安徽省和县人民法院	安徽
安徽省怀宁县人民法院	安徽
安徽省怀远县人民法院	安徽
安徽省淮北市杜集区人民法院	安徽
安徽省淮北市烈山区人民法院	安徽
安徽省淮北市相山区人民法院	安徽
安徽省淮北市中级人民法院	安徽
安徽省淮南市八公山区人民法院	安徽
安徽省淮南市大通区人民法院	安徽
安徽省淮南市潘集区人民法院	安徽
安徽省淮南市田家庵区人民法院	安徽
安徽省淮南市谢家集区人民法院	安徽
安徽省淮南市中级人民法院	安徽
安徽省黄山市黄山区人民法院	安徽
安徽省黄山市徽州区人民法院	安徽
安徽省黄山市屯溪区人民法院	安徽
安徽省黄山市中级人民法院	安徽
安徽省霍邱县人民法院	安徽
安徽省霍山县人民法院	安徽
安徽省绩溪县人民法院	安徽
安徽省界首市人民法院	安徽
安徽省金寨县人民法院	安徽
安徽省泾县人民法院	安徽
安徽省旌德县人民法院	安徽
安徽省九华山风景区人民法院	安徽
安徽省来安县人民法院	安徽
安徽省郎溪县人民法院	安徽
安徽省利辛县人民法院	安徽
安徽省临泉县人民法院	安徽
安徽省灵璧县人民法院	安徽
安徽省六安市金安区人民法院	安徽
安徽省六安市叶集区人民法院	安徽
安徽省六安市裕安区人民法院	安徽
安徽省六安市中级人民法院	安徽
安徽省庐江县人民法院	安徽
安徽省马鞍山市博望区人民法院	安徽
安徽省马鞍山市花山区人民法院	安徽
安徽省马鞍山市雨山区人民法院	安徽
安徽省马鞍山市中级人民法院	安徽
安徽省蒙城县人民法院	安徽
安徽省明光市人民法院	安徽
安徽省南陵县人民法院	安徽
安徽省宁国市人民法院	安徽
安徽省祁门县人民法院	安徽
安徽省潜山县人民法院	安徽
安徽省青阳县人民法院	安徽
安徽省全椒县人民法院	安徽
安徽省石台县人民法院	安徽
安徽省寿县人民法院	安徽
安徽省舒城县人民法院	安徽
安徽省泗县人民法院	安徽
安徽省濉溪县人民法院	安徽
安徽省太和县人民法院	安徽
安徽省太湖县人民法院	安徽
安徽省天长市人民法院	安徽
安徽省桐城市人民法院	安徽
安徽省铜官区人民法院	安徽
安徽省铜陵市郊区人民法院	安徽
安徽省铜陵市狮子山区人民法院	安徽
安徽省铜陵市铜官山区人民法院	安徽
安徽省铜陵市中级人民法院	安徽
安徽省铜陵县人民法院	安徽
安徽省望江县人民法院	安徽
安徽省涡阳县人民法院	安徽
安徽省无为县人民法院	安徽
安徽省芜湖经济技术开发区人民法院	安徽
安徽省芜湖市镜湖区人民法院	安徽
安徽省芜湖市鸠江区人民法院	安徽
安徽省芜湖市三山区人民法院	安徽
安徽省芜湖市弋江区人民法院	安徽
安徽省芜湖市中级人民法院	安徽
安徽省芜湖县人民法院	安徽
安徽省五河县人民法院	安徽
安徽省歙县人民法院	安徽
安徽省萧县人民法院	安徽
安徽省休宁县人民法院	安徽
安徽省宿松县人民法院	安徽
安徽省宿州市埇桥区人民法院	安徽
安徽省宿州市中级人民法院	安徽
安徽省宣城市宣州区人民法院	安徽
安徽省宣城市中级人民法院	安徽
安徽省叶集改革发展实验区人民法院	安徽
安徽省叶集改革发展试验区人民法院	安徽
安徽省黟县人民法院	安徽
安徽省义安区人民法院	安徽
安徽省颍上县人民法院	安徽
安徽省岳西县人民法院	安徽
安徽省长丰县人民法院	安徽
北京市昌平区人民法院	北京
北京市朝阳区人民法院	北京
北京市大兴区人民法院	北京
北京市第二中级人民法院	北京
北京市第三中级人民法院	北京
北京市第四中级人民法院	北京
北京市第一中级人民法院	北京
北京市东城区人民法院	北京
北京市房山区人民法院	北京
北京市丰台区人民法院	北京
北京市高级人民法院	北京
北京市海淀区人民法院	北京
北京市怀柔区人民法院	北京
北京市门头沟区人民法院	北京
北京市密云区人民法院	北京
北京市平谷区人民法院	北京
北京市石景山区人民法院	北京
北京市顺义区人民法院	北京
北京市通州区人民法院	北京
北京市西城区人民法院	北京
北京市延庆区人民法院	北京
北京铁路运输法院	北京
北京知识产权法院	北京
福建省安溪县人民法院	福建
福建省大田县人民法院	福建
福建省德化县人民法院	福建
福建省东山县人民法院	福建
福建省福安市人民法院	福建
福建省福鼎市人民法院	福建
福建省福清市人民法院	福建
福建省福州市仓山区人民法院	福建
福建省福州市鼓楼区人民法院	福建
福建省福州市晋安区人民法院	福建
福建省福州市马尾区人民法院	福建
福建省福州市台江区人民法院	福建
福建省福州市中级人民法院	福建
福建省福州铁路运输法院	福建
福建省高级人民法院	福建
福建省古田县人民法院	福建
福建省光泽县人民法院	福建
福建省华安县人民法院	福建
福建省惠安县人民法院	福建
福建省建宁县人民法院	福建
福建省建瓯市人民法院	福建
福建省将乐县人民法院	福建
福建省晋江市人民法院	福建
福建省连城县人民法院	福建
福建省连江县人民法院	福建
福建省龙海市人民法院	福建
福建省龙泉市永定区人民法院	福建
福建省龙岩市新罗区人民法院	福建
福建省龙岩市中级人民法院	福建
福建省罗源县人民法院	福建
福建省闽侯县人民法院	福建
福建省闽清县人民法院	福建
福建省明溪县人民法院	福建
福建省南安市人民法院	福建
福建省南靖县人民法院	福建
福建省南平市建阳区人民法院	福建
福建省南平市延平区人民法院	福建
福建省南平市中级人民法院	福建
福建省宁德市蕉城区人民法院	福建
福建省宁德市中级人民法院	福建
福建省宁化县人民法院	福建
福建省平和县人民法院	福建
福建省平潭县人民法院	福建
福建省平潭综合实验区人民法院	福建
福建省屏南县人民法院	福建
福建省莆田市城厢区人民法院	福建
福建省莆田市涵江区人民法院	福建
福建省莆田市荔城区人民法院	福建
福建省莆田市秀屿区人民法院	福建
福建省莆田市中级人民法院	福建
福建省浦城县人民法院	福建
福建省清流县人民法院	福建
福建省泉州市丰泽区人民法院	福建
福建省泉州市鲤城区人民法院	福建
福建省泉州市洛江区人民法院	福建
福建省泉州市泉港区人民法院	福建
福建省泉州市中级人民法院	福建
福建省三明市梅列区人民法院	福建
福建省三明市三元区人民法院	福建
福建省三明市中级人民法院	福建
福建省沙县人民法院	福建
福建省厦门海事法院	福建
福建省厦门市海沧区人民法院	福建
福建省厦门市湖里区人民法院	福建
福建省厦门市集美区人民法院	福建
福建省厦门市思明区人民法院	福建
福建省厦门市同安区人民法院	福建
福建省厦门市翔安区人民法院	福建
福建省厦门市中级人民法院	福建
福建省上杭县人民法院	福建
福建省邵武市人民法院	福建
福建省石狮市人民法院	福建
福建省寿宁县人民法院	福建
福建省顺昌县人民法院	福建
福建省松溪县人民法院	福建
福建省泰宁县人民法院	福建
福建省武平县人民法院	福建
福建省武夷山市人民法院	福建
福建省霞浦县人民法院	福建
福建省仙游县人民法院	福建
福建省永安市人民法院	福建
福建省永春县人民法院	福建
福建省永泰县人民法院	福建
福建省尤溪县人民法院	福建
福建省云霄县人民法院	福建
福建省漳平市人民法院	福建
福建省漳浦县人民法院	福建
福建省漳州市龙文区人民法院	福建
福建省漳州市芗城区人民法院	福建
福建省漳州市中级人民法院	福建
福建省长乐市人民法院	福建
福建省长泰县人民法院	福建
福建省长汀县人民法院	福建
福建省诏安县人民法院	福建
福建省柘荣县人民法院	福建
福建省政和县人民法院	福建
福建省周宁县人民法院	福建
甘肃省阿克塞哈萨克族自治县人民法院	甘肃
甘肃省白银市白银区人民法院	甘肃
甘肃省白银市平川区人民法院	甘肃
甘肃省白银市中级人民法院	甘肃
甘肃省成县人民法院	甘肃
甘肃省崇信县人民法院	甘肃
甘肃省宕昌县人民法院	甘肃
甘肃省迭部林区基层法院	甘肃
甘肃省迭部县人民法院	甘肃
甘肃省定西市安定区人民法院	甘肃
甘肃省定西市中级人民法院	甘肃
甘肃省东乡族自治县人民法院	甘肃
甘肃省敦煌市人民法院	甘肃
甘肃省甘谷县人民法院	甘肃
甘肃省甘南藏族自治州中级人民法院	甘肃
甘肃省甘肃矿区人民法院	甘肃
甘肃省甘肃省林区中级法院	甘肃
甘肃省皋兰县人民法院	甘肃
甘肃省高级人民法院	甘肃
甘肃省高台县人民法院	甘肃
甘肃省古浪县人民法院	甘肃
甘肃省瓜州县人民法院	甘肃
甘肃省广河县人民法院	甘肃
甘肃省合水县人民法院	甘肃
甘肃省合作市人民法院	甘肃
甘肃省和政县人民法院	甘肃
甘肃省华池县人民法院	甘肃
甘肃省华亭县人民法院	甘肃
甘肃省环县人民法院	甘肃
甘肃省徽县人民法院	甘肃
甘肃省会宁县人民法院	甘肃
甘肃省积石山保安族东乡族撒拉族自治县人民法院	甘肃
甘肃省嘉峪关市城区人民法院	甘肃
甘肃省嘉峪关市中级人民法院	甘肃
甘肃省金昌市金川区人民法院	甘肃
甘肃省金昌市中级人民法院	甘肃
甘肃省金塔县人民法院	甘肃
甘肃省泾川县人民法院	甘肃
甘肃省景泰县人民法院	甘肃
甘肃省靖远县人民法院	甘肃
甘肃省静宁县人民法院	甘肃
甘肃省酒泉市肃州区人民法院	甘肃
甘肃省酒泉市中级人民法院	甘肃
甘肃省康乐县人民法院	甘肃
甘肃省康县人民法院	甘肃
甘肃省兰州市安宁区人民法院	甘肃
甘肃省兰州市城关区人民法院	甘肃
甘肃省兰州市红古区人民法院	甘肃
甘肃省兰州市七里河区人民法院	甘肃
甘肃省兰州市西固区人民法院	甘肃
甘肃省兰州市新区人民法院	甘肃
甘肃省兰州市中级人民法院	甘肃
甘肃省兰州铁路运输法院	甘肃
甘肃省兰州铁路运输中级法院	甘肃
甘肃省礼县人民法院	甘肃
甘肃省两当县人民法院	甘肃
甘肃省临潭县人民法院	甘肃
甘肃省临洮县人民法院	甘肃
甘肃省临夏回族自治州中级人民法院	甘肃
甘肃省临夏市人民法院	甘肃
甘肃省临夏县人民法院	甘肃
甘肃省临泽县人民法院	甘肃
甘肃省灵台县人民法院	甘肃
甘肃省陇南市武都区人民法院	甘肃
甘肃省陇南市中级人民法院	甘肃
甘肃省陇西县人民法院	甘肃
甘肃省碌曲县人民法院	甘肃
甘肃省玛曲县人民法院	甘肃
甘肃省民乐县人民法院	甘肃
甘肃省民勤县人民法院	甘肃
甘肃省岷县人民法院	甘肃
甘肃省宁县人民法院	甘肃
甘肃省平凉市崆峒区人民法院	甘肃
甘肃省平凉市中级人民法院	甘肃
甘肃省秦安县人民法院	甘肃
甘肃省清水县人民法院	甘肃
甘肃省庆城县人民法院	甘肃
甘肃省庆阳林区基层法院	甘肃
甘肃省庆阳市西峰区人民法院	甘肃
甘肃省庆阳市中级人民法院	甘肃
甘肃省山丹县人民法院	甘肃
甘肃省肃北蒙古族自治县人民法院	甘肃
甘肃省肃南裕固族自治县人民法院	甘肃
甘肃省天水市麦积区人民法院	甘肃
甘肃省天水市秦州区人民法院	甘肃
甘肃省天水市中级人民法院	甘肃
甘肃省天祝藏族自治县人民法院	甘肃
甘肃省通渭县人民法院	甘肃
甘肃省渭源县人民法院	甘肃
甘肃省文县林区基层法院	甘肃
甘肃省文县人民法院	甘肃
甘肃省武山县人民法院	甘肃
甘肃省武威市凉州区人民法院	甘肃
甘肃省武威市中级人民法院	甘肃
甘肃省武威铁路运输法院	甘肃
甘肃省西和县人民法院	甘肃
甘肃省夏河县人民法院	甘肃
甘肃省永昌县人民法院	甘肃
甘肃省永登县人民法院	甘肃
甘肃省永靖县人民法院	甘肃
甘肃省榆中县人民法院	甘肃
甘肃省玉门市人民法院	甘肃
甘肃省张家川回族自治县人民法院	甘肃
甘肃省张掖市甘州区人民法院	甘肃
甘肃省张掖市中级人民法院	甘肃
甘肃省漳县人民法院	甘肃
甘肃省镇原县人民法院	甘肃
甘肃省正宁县人民法院	甘肃
甘肃省舟曲林区基层法院	甘肃
甘肃省舟曲县人民法院	甘肃
甘肃省庄浪县人民法院	甘肃
甘肃省卓尼林区基层法院	甘肃
甘肃省卓尼县人民法院	甘肃
广东省博罗县人民法院	广东
广东省潮州市潮安区人民法院	广东
广东省潮州市枫溪人民法院	广东
广东省潮州市湘桥区人民法院	广东
广东省潮州市中级人民法院	广东
广东省从化市人民法院	广东
广东省大埔县人民法院	广东
广东省德庆县人民法院	广东
广东省东莞市第二人民法院	广东
广东省东莞市第三人民法院	广东
广东省东莞市第一人民法院	广东
广东省东莞市中级人民法院	广东
广东省东源县人民法院	广东
广东省恩平市人民法院	广东
广东省丰顺县人民法院	广东
广东省封开县人民法院	广东
广东省佛冈县人民法院	广东
广东省佛山市禅城区人民法院	广东
广东省佛山市高明区人民法院	广东
广东省佛山市南海区人民法院	广东
广东省佛山市三水区人民法院	广东
广东省佛山市顺德区人民法院	广东
广东省佛山市中级人民法院	广东
广东省高级人民法院	广东
广东省高要市人民法院	广东
广东省高州市人民法院	广东
广东省广东自由贸易区南沙片区人民法院	广东
广东省广宁县人民法院	广东
广东省广州海事法院	广东
广东省广州市白云区人民法院	广东
广东省广州市番禺区人民法院	广东
广东省广州市海珠区人民法院	广东
广东省广州市花都区人民法院	广东
广东省广州市黄埔区人民法院	广东
广东省广州市荔湾区人民法院	广东
广东省广州市南沙区人民法院	广东
广东省广州市天河区人民法院	广东
广东省广州市越秀区人民法院	广东
广东省广州市中级人民法院	广东
广东省广州铁路运输第二法院	广东
广东省广州铁路运输第一法院	广东
广东省广州铁路运输法院	广东
广东省广州铁路运输中级法院	广东
广东省广州知识产权法院	广东
广东省海丰县人民法院	广东
广东省和平县人民法院	广东
广东省河源市源城区人民法院	广东
广东省河源市中级人民法院	广东
广东省鹤山市人民法院	广东
广东省化州市人民法院	广东
广东省怀集县人民法院	广东
广东省惠东县人民法院	广东
广东省惠来县人民法院	广东
广东省惠州市大亚湾经济技术开发区人民法院	广东
广东省惠州市惠城区人民法院	广东
广东省惠州市惠阳区人民法院	广东
广东省惠州市中级人民法院	广东
广东省江门市江海区人民法院	广东
广东省江门市蓬江区人民法院	广东
广东省江门市新会区人民法院	广东
广东省江门市中级人民法院	广东
广东省蕉岭县人民法院	广东
广东省揭西县人民法院	广东
广东省揭阳市揭东区人民法院	广东
广东省揭阳市榕城区人民法院	广东
广东省揭阳市中级人民法院	广东
广东省开平市人民法院	广东
广东省乐昌市人民法院	广东
广东省雷州市人民法院	广东
广东省连南瑶族自治县人民法院	广东
广东省连平县人民法院	广东
广东省连山壮族瑶族自治县人民法院	广东
广东省连州市人民法院	广东
广东省廉江市人民法院	广东
广东省龙川县人民法院	广东
广东省龙门县人民法院	广东
广东省陆丰市人民法院	广东
广东省陆河县人民法院	广东
广东省罗定市人民法院	广东
广东省茂名市电白区人民法院	广东
广东省茂名市茂南区人民法院	广东
广东省茂名市中级人民法院	广东
广东省梅州市梅江区人民法院	广东
广东省梅州市梅县区人民法院	广东
广东省梅州市中级人民法院	广东
广东省南澳县人民法院	广东
广东省南雄市人民法院	广东
广东省平远县人民法院	广东
广东省普宁市人民法院	广东
广东省清远市清城区人民法院	广东
广东省清远市清新区人民法院	广东
广东省清远市中级人民法院	广东
广东省饶平县人民法院	广东
广东省仁化县人民法院	广东
广东省乳源瑶族自治县人民法院	广东
广东省汕头市潮南区人民法院	广东
广东省汕头市潮阳区人民法院	广东
广东省汕头市澄海区人民法院	广东
广东省汕头市濠江区人民法院	广东
广东省汕头市金平区人民法院	广东
广东省汕头市龙湖区人民法院	广东
广东省汕头市中级人民法院	广东
广东省汕尾市城区人民法院	广东
广东省汕尾市中级人民法院	广东
广东省韶关市曲江区人民法院	广东
广东省韶关市武江区人民法院	广东
广东省韶关市浈江区人民法院	广东
广东省韶关市中级人民法院	广东
广东省深圳前海合作区人民法院	广东
广东省深圳市宝安区人民法院	广东
广东省深圳市福田区人民法院	广东
广东省深圳市龙岗区人民法院	广东
广东省深圳市罗湖区人民法院	广东
广东省深圳市南山区人民法院	广东
广东省深圳市盐田区人民法院	广东
广东省深圳市中级人民法院	广东
广东省始兴县人民法院	广东
广东省四会市人民法院	广东
广东省遂溪县人民法院	广东
广东省台山市人民法院	广东
广东省翁源县人民法院	广东
广东省吴川市人民法院	广东
广东省五华县人民法院	广东
广东省新丰县人民法院	广东
广东省新兴县人民法院	广东
广东省信宜市人民法院	广东
广东省兴宁市人民法院	广东
广东省徐闻县人民法院	广东
广东省阳春市人民法院	广东
广东省阳江市江城区人民法院	广东
广东省阳江市阳东区人民法院	广东
广东省阳江市中级人民法院	广东
广东省阳山县人民法院	广东
广东省阳西县人民法院	广东
广东省英德市人民法院	广东
广东省郁南县人民法院	广东
广东省云浮市云安区人民法院	广东
广东省云浮市云城区人民法院	广东
广东省云浮市中级人民法院	广东
广东省增城市人民法院	广东
广东省湛江经济技术开发区人民法院	广东
广东省湛江市赤坎区人民法院	广东
广东省湛江市麻章区人民法院	广东
广东省湛江市坡头区人民法院	广东
广东省湛江市霞山区人民法院	广东
广东省湛江市中级人民法院	广东
广东省肇庆市鼎湖区人民法院	广东
广东省肇庆市端州区人民法院	广东
广东省肇庆市高要区人民法院	广东
广东省肇庆市中级人民法院	广东
广东省肇庆铁路运输法院	广东
广东省中山市第二人民法院	广东
广东省中山市第一人民法院	广东
广东省中山市中级人民法院	广东
广东省珠海横琴新区人民法院	广东
广东省珠海市斗门区人民法院	广东
广东省珠海市金湾区人民法院	广东
广东省珠海市香州区人民法院	广东
广东省珠海市香洲区人民法院	广东
广东省珠海市中级人民法院	广东
广东省紫金县人民法院	广东
广西壮族自治区巴马瑶族自治县人民法院	广西
广西壮族自治区百色市右江区人民法院	广西
广西壮族自治区百色市中级人民法院	广西
广西壮族自治区北海海事法院	广西
广西壮族自治区北海市海城区人民法院	广西
广西壮族自治区北海市铁山港区人民法院	广西
广西壮族自治区北海市银海区人民法院	广西
广西壮族自治区北海市中级人民法院	广西
广西壮族自治区北流市人民法院	广西
广西壮族自治区宾阳县人民法院	广西
广西壮族自治区博白县人民法院	广西
广西壮族自治区苍梧县人民法院	广西
广西壮族自治区岑溪市人民法院	广西
广西壮族自治区崇左市江州区人民法院	广西
广西壮族自治区崇左市中级人民法院	广西
广西壮族自治区大化瑶族自治县人民法院	广西
广西壮族自治区大新县人民法院	广西
广西壮族自治区德保县人民法院	广西
广西壮族自治区东兰县人民法院	广西
广西壮族自治区东兴市人民法院	广西
广西壮族自治区都安瑶族自治县人民法院	广西
广西壮族自治区防城港市防城区人民法院	广西
广西壮族自治区防城港市港口区人民法院	广西
广西壮族自治区防城港市中级人民法院	广西
广西壮族自治区凤山县人民法院	广西
广西壮族自治区扶绥县人民法院	广西
广西壮族自治区富川瑶族自治县人民法院	广西
广西壮族自治区高级人民法院	广西
广西壮族自治区恭城瑶族自治县人民法院	广西
广西壮族自治区灌阳县人民法院	广西
广西壮族自治区贵港市港北区人民法院	广西
广西壮族自治区贵港市港南区人民法院	广西
广西壮族自治区贵港市覃塘区人民法院	广西
广西壮族自治区贵港市中级人民法院	广西
广西壮族自治区桂林市叠彩区人民法院	广西
广西壮族自治区桂林市临桂区人民法院	广西
广西壮族自治区桂林市七星区人民法院	广西
广西壮族自治区桂林市象山区人民法院	广西
广西壮族自治区桂林市秀峰区人民法院	广西
广西壮族自治区桂林市雁山区人民法院	广西
广西壮族自治区桂林市中级人民法院	广西
广西壮族自治区桂平市人民法院	广西
广西壮族自治区合浦县人民法院	广西
广西壮族自治区合山市人民法院	广西
广西壮族自治区河池市金城江区人民法院	广西
广西壮族自治区河池市中级人民法院	广西
广西壮族自治区贺州市八步区人民法院	广西
广西壮族自治区贺州市中级人民法院	广西
广西壮族自治区横县人民法院	广西
广西壮族自治区环江毛南族自治县人民法院	广西
广西壮族自治区金秀瑶族自治县人民法院	广西
广西壮族自治区靖西市人民法院	广西
广西壮族自治区靖西县人民法院	广西
广西壮族自治区来宾市兴宾区人民法院	广西
广西壮族自治区来宾市中级人民法院	广西
广西壮族自治区乐业县人民法院	广西
广西壮族自治区荔浦县人民法院	广西
广西壮族自治区临桂县人民法院	广西
广西壮族自治区灵川县人民法院	广西
广西壮族自治区灵山县人民法院	广西
广西壮族自治区凌云县人民法院	广西
广西壮族自治区柳城县人民法院	广西
广西壮族自治区柳江县人民法院	广西
广西壮族自治区柳州市城中区人民法院	广西
广西壮族自治区柳州市柳北区人民法院	广西
广西壮族自治区柳州市柳南区人民法院	广西
广西壮族自治区柳州市鱼峰区人民法院	广西
广西壮族自治区柳州市中级人民法院	广西
广西壮族自治区柳州铁路运输法院	广西
广西壮族自治区龙胜各族自治县人民法院	广西
广西壮族自治区龙州县人民法院	广西
广西壮族自治区隆安县人民法院	广西
广西壮族自治区隆林各族自治县人民法院	广西
广西壮族自治区陆川县人民法院	广西
广西壮族自治区鹿寨县人民法院	广西
广西壮族自治区罗城仫佬族自治县人民法院	广西
广西壮族自治区马山县人民法院	广西
广西壮族自治区蒙山县人民法院	广西
广西壮族自治区那坡县人民法院	广西
广西壮族自治区南丹县人民法院	广西
广西壮族自治区南宁市江南区人民法院	广西
广西壮族自治区南宁市良庆区人民法院	广西
广西壮族自治区南宁市青秀区人民法院	广西
广西壮族自治区南宁市西乡塘区人民法院	广西
广西壮族自治区南宁市兴宁区人民法院	广西
广西壮族自治区南宁市邕宁区人民法院	广西
广西壮族自治区南宁市中级人民法院	广西
广西壮族自治区南宁铁路运输法院	广西
广西壮族自治区南宁铁路运输中级法院	广西
广西壮族自治区宁明县人民法院	广西
广西壮族自治区平果县人民法院	广西
广西壮族自治区平乐县人民法院	广西
广西壮族自治区平南县人民法院	广西
广西壮族自治区凭祥市人民法院	广西
广西壮族自治区浦北县人民法院	广西
广西壮族自治区钦州市钦北区人民法院	广西
广西壮族自治区钦州市钦南区人民法院	广西
广西壮族自治区钦州市中级人民法院	广西
广西壮族自治区全州县人民法院	广西
广西壮族自治区容县人民法院	广西
广西壮族自治区融安县人民法院	广西
广西壮族自治区融水苗族自治县人民法院	广西
广西壮族自治区三江侗族自治县人民法院	广西
广西壮族自治区上林县人民法院	广西
广西壮族自治区上思县人民法院	广西
广西壮族自治区藤县人民法院	广西
广西壮族自治区天等县人民法院	广西
广西壮族自治区天峨县人民法院	广西
广西壮族自治区田东县人民法院	广西
广西壮族自治区田林县人民法院	广西
广西壮族自治区田阳县人民法院	广西
广西壮族自治区梧州市龙圩区人民法院	广西
广西壮族自治区梧州市万秀区人民法院	广西
广西壮族自治区梧州市长洲区人民法院	广西
广西壮族自治区梧州市中级人民法院	广西
广西壮族自治区武鸣县人民法院	广西
广西壮族自治区武宣县人民法院	广西
广西壮族自治区西林县人民法院	广西
广西壮族自治区象州县人民法院	广西
广西壮族自治区忻城县人民法院	广西
广西壮族自治区兴安县人民法院	广西
广西壮族自治区兴业县人民法院	广西
广西壮族自治区阳朔县人民法院	广西
广西壮族自治区宜州市人民法院	广西
广西壮族自治区永福县人民法院	广西
广西壮族自治区玉林市福绵区人民法院	广西
广西壮族自治区玉林市玉州区人民法院	广西
广西壮族自治区玉林市中级人民法院	广西
广西壮族自治区昭平县人民法院	广西
广西壮族自治区钟山县人民法院	广西
广西壮族自治区资源县人民法院	广西
贵州省安龙县人民法院	贵州
贵州省安顺市平坝区人民法院	贵州
贵州省安顺市西秀区人民法院	贵州
贵州省安顺市中级人民法院	贵州
贵州省毕节市七星关区人民法院	贵州
贵州省毕节市中级人民法院	贵州
贵州省册亨县人民法院	贵州
贵州省岑巩县人民法院	贵州
贵州省赤水市人民法院	贵州
贵州省从江县人民法院	贵州
贵州省大方县人民法院	贵州
贵州省丹寨县人民法院	贵州
贵州省道真仡佬族苗族自治县人民法院	贵州
贵州省德江县人民法院	贵州
贵州省都匀市人民法院	贵州
贵州省独山县人民法院	贵州
贵州省凤冈县人民法院	贵州
贵州省福泉市人民法院	贵州
贵州省高级人民法院	贵州
贵州省关岭布依族苗族自治县人民法院	贵州
贵州省贵定县人民法院	贵州
贵州省贵阳市白云区人民法院	贵州
贵州省贵阳市观山湖区人民法院	贵州
贵州省贵阳市花溪区人民法院	贵州
贵州省贵阳市南明区人民法院	贵州
贵州省贵阳市乌当区人民法院	贵州
贵州省贵阳市云岩区人民法院	贵州
贵州省贵阳市中级人民法院	贵州
贵州省贵阳铁路运输法院	贵州
贵州省贵州省遵义市中级人民法院	贵州
贵州省赫章县人民法院	贵州
贵州省黄平县人民法院	贵州
贵州省惠水县人民法院	贵州
贵州省剑河县人民法院	贵州
贵州省江口县人民法院	贵州
贵州省金沙县人民法院	贵州
贵州省锦屏县人民法院	贵州
贵州省开阳县人民法院	贵州
贵州省凯里市人民法院	贵州
贵州省雷山县人民法院	贵州
贵州省黎平县人民法院	贵州
贵州省荔波县人民法院	贵州
贵州省六盘水市六枝特区人民法院	贵州
贵州省六盘水市中级人民法院	贵州
贵州省六盘水市钟山区人民法院	贵州
贵州省龙里县人民法院	贵州
贵州省罗甸县人民法院	贵州
贵州省麻江县人民法院	贵州
贵州省湄潭县人民法院	贵州
贵州省纳雍县人民法院	贵州
贵州省盘县人民法院	贵州
贵州省平塘县人民法院	贵州
贵州省普安县人民法院	贵州
贵州省普定县人民法院	贵州
贵州省黔东南苗族侗族自治州中级人民法院	贵州
贵州省黔南布依族苗族自治州中级人民法院	贵州
贵州省黔西南布依族苗族自治州中级人民法院	贵州
贵州省黔西县人民法院	贵州
贵州省清镇市人民法院	贵州
贵州省晴隆县人民法院	贵州
贵州省仁怀市人民法院	贵州
贵州省榕江县人民法院	贵州
贵州省三都水族自治县人民法院	贵州
贵州省三穗县人民法院	贵州
贵州省施秉县人民法院	贵州
贵州省石阡县人民法院	贵州
贵州省水城县人民法院	贵州
贵州省思南县人民法院	贵州
贵州省松桃苗族自治县人民法院	贵州
贵州省绥阳县人民法院	贵州
贵州省台江县人民法院	贵州
贵州省天柱县人民法院	贵州
贵州省桐梓县人民法院	贵州
贵州省铜仁市碧江区人民法院	贵州
贵州省铜仁市万山区人民法院	贵州
贵州省铜仁市中级人民法院	贵州
贵州省望谟县人民法院	贵州
贵州省威宁彝族回族苗族自治县人民法院	贵州
贵州省瓮安县人民法院	贵州
贵州省务川仡佬族苗族自治县人民法院	贵州
贵州省息烽县人民法院	贵州
贵州省习水县人民法院	贵州
贵州省兴仁县人民法院	贵州
贵州省兴义市人民法院	贵州
贵州省修文县人民法院	贵州
贵州省沿河土家族自治县人民法院	贵州
贵州省印江土家族苗族自治县人民法院	贵州
贵州省余庆县人民法院	贵州
贵州省玉屏侗族自治县人民法院	贵州
贵州省长顺县人民法院	贵州
贵州省贞丰县人民法院	贵州
贵州省镇宁布依族苗族自治县人民法院	贵州
贵州省镇远县人民法院	贵州
贵州省正安县人民法院	贵州
贵州省织金县人民法院	贵州
贵州省紫云苗族布依族自治县人民法院	贵州
贵州省遵义市红花岗区人民法院	贵州
贵州省遵义市汇川区人民法院	贵州
贵州省遵义市中级人民法院	贵州
贵州省遵义县人民法院	贵州
海南省白沙黎族自治县人民法院	海南
海南省保亭黎族苗族自治县人民法院	海南
海南省昌江黎族自治县人民法院	海南
海南省澄迈县人民法院	海南
海南省儋州市人民法院	海南
海南省定安县人民法院	海南
海南省东方市人民法院	海南
海南省高级人民法院	海南
海南省海口海事法院	海南
海南省海口市龙华区人民法院	海南
海南省海口市美兰区人民法院	海南
海南省海口市琼山区人民法院	海南
海南省海口市秀英区人民法院	海南
海南省海口市中级人民法院	海南
海南省海南省第二中级人民法院	海南
海南省海南省第一中级人民法院	海南
海南省海南省三沙市中级人民法院	海南
海南省海南省洋浦经济开发区人民法院	海南
海南省乐东黎族自治县人民法院	海南
海南省临高县人民法院	海南
海南省陵水黎族自治县人民法院	海南
海南省琼海市人民法院	海南
海南省琼中黎族苗族自治县人民法院	海南
海南省三沙市三沙群岛人民法院	海南
海南省三亚市城郊人民法院	海南
海南省三亚市中级人民法院	海南
海南省屯昌县人民法院	海南
海南省万宁市人民法院	海南
海南省文昌市人民法院	海南
海南省五指山市人民法院	海南
河北省安国市人民法院	河北
河北省安平县人民法院	河北
河北省安新县人民法院	河北
河北省霸州市人民法院	河北
河北省柏乡县人民法院	河北
河北省保定市竞秀区人民法院	河北
河北省保定市莲池区人民法院	河北
河北省保定市满城区人民法院	河北
河北省保定市清苑区人民法院	河北
河北省保定市徐水区人民法院	河北
河北省保定市中级人民法院	河北
河北省泊头市人民法院	河北
河北省博野县人民法院	河北
河北省沧县人民法院	河北
河北省沧州市新华区人民法院	河北
河北省沧州市运河区人民法院	河北
河北省沧州市中级人民法院	河北
河北省昌黎县人民法院	河北
河北省成安县人民法院	河北
河北省承德市双滦区人民法院	河北
河北省承德市双桥区人民法院	河北
河北省承德市鹰手营子矿区人民法院	河北
河北省承德市中级人民法院	河北
河北省承德县人民法院	河北
河北省赤城县人民法院	河北
河北省崇礼县人民法院	河北
河北省磁县人民法院	河北
河北省大厂回族自治县人民法院	河北
河北省大城县人民法院	河北
河北省大名县人民法院	河北
河北省定兴县人民法院	河北
河北省定州市人民法院	河北
河北省东光县人民法院	河北
河北省肥乡县人民法院	河北
河北省丰宁满族自治县人民法院	河北
河北省抚宁县人民法院	河北
河北省阜城县人民法院	河北
河北省阜平县人民法院	河北
河北省高碑店市人民法院	河北
河北省高级人民法院	河北
河北省高阳县人民法院	河北
河北省高邑县人民法院	河北
河北省沽源县人民法院	河北
河北省固安县人民法院	河北
河北省故城县人民法院	河北
河北省馆陶县人民法院	河北
河北省广平县人民法院	河北
河北省广宗县人民法院	河北
河北省海兴县人民法院	河北
河北省邯郸市丛台区人民法院	河北
河北省邯郸市峰峰矿区人民法院	河北
河北省邯郸市复兴区人民法院	河北
河北省邯郸市邯山区人民法院	河北
河北省邯郸市中级人民法院	河北
河北省邯郸县人民法院	河北
河北省行唐县人民法院	河北
河北省河间市人民法院	河北
河北省衡水市桃城区人民法院	河北
河北省衡水市中级人民法院	河北
河北省怀安县人民法院	河北
河北省怀来县人民法院	河北
河北省黄骅市人民法院	河北
河北省鸡泽县人民法院	河北
河北省冀州市人民法院	河北
河北省晋州市人民法院	河北
河北省井陉县人民法院	河北
河北省景县人民法院	河北
河北省巨鹿县人民法院	河北
河北省康保县人民法院	河北
河北省宽城满族自治县人民法院	河北
河北省涞水县人民法院	河北
河北省涞源县人民法院	河北
河北省廊坊市安次区人民法院	河北
河北省廊坊市广阳区人民法院	河北
河北省廊坊市经济技术开发区人民法院	河北
河北省廊坊市中级人民法院	河北
河北省乐亭县人民法院	河北
河北省蠡县人民法院	河北
河北省临城县人民法院	河北
河北省临西县人民法院	河北
河北省临漳县人民法院	河北
河北省灵寿县人民法院	河北
河北省隆化县人民法院	河北
河北省隆尧县人民法院	河北
河北省卢龙县人民法院	河北
河北省滦南县人民法院	河北
河北省滦平县人民法院	河北
河北省滦县人民法院	河北
河北省孟村回族自治县人民法院	河北
河北省南宫市人民法院	河北
河北省南和县人民法院	河北
河北省南皮县人民法院	河北
河北省内丘县人民法院	河北
河北省宁晋县人民法院	河北
河北省平泉县人民法院	河北
河北省平山县人民法院	河北
河北省平乡县人民法院	河北
河北省迁安市人民法院	河北
河北省迁西县人民法院	河北
河北省秦皇岛北戴河新区人民法院	河北
河北省秦皇岛经济技术开发区人民法院	河北
河北省秦皇岛市北戴河区人民法院	河北
河北省秦皇岛市抚宁区人民法院	河北
河北省秦皇岛市海港区人民法院	河北
河北省秦皇岛市山海关区人民法院	河北
河北省秦皇岛市中级人民法院	河北
河北省青龙满族自治县人民法院	河北
河北省青县人民法院	河北
河北省清河县人民法院	河北
河北省邱县人民法院	河北
河北省曲阳县人民法院	河北
河北省曲周县人民法院	河北
河北省饶阳县人民法院	河北
河北省任丘市人民法院	河北
河北省任县人民法院	河北
河北省容城县人民法院	河北
河北省三河市人民法院	河北
河北省沙河市人民法院	河北
河北省尚义县人民法院	河北
河北省涉县人民法院	河北
河北省深泽县人民法院	河北
河北省深州市人民法院	河北
河北省石家庄高新技术产业开发区人民法院	河北
河北省石家庄市藁城区人民法院	河北
河北省石家庄市井陉矿区人民法院	河北
河北省石家庄市鹿泉区人民法院	河北
河北省石家庄市栾城区人民法院	河北
河北省石家庄市桥西区人民法院	河北
河北省石家庄市新华区人民法院	河北
河北省石家庄市裕华区人民法院	河北
河北省石家庄市长安区人民法院	河北
河北省石家庄市中级人民法院	河北
河北省石家庄铁路运输法院	河北
河北省顺平县人民法院	河北
河北省肃宁县人民法院	河北
河北省唐山高新技术产业开发区人民法院	河北
河北省唐山市曹妃甸区人民法院	河北
河北省唐山市丰南区人民法院	河北
河北省唐山市丰润区人民法院	河北
河北省唐山市古冶区人民法院	河北
河北省唐山市开平区人民法院	河北
河北省唐山市路北区人民法院	河北
河北省唐山市路南区人民法院	河北
河北省唐山市中级人民法院	河北
河北省唐县人民法院	河北
河北省万全县人民法院	河北
河北省望都县人民法院	河北
河北省威县人民法院	河北
河北省围场满族蒙古族自治县人民法院	河北
河北省蔚县人民法院	河北
河北省魏县人民法院	河北
河北省文安县人民法院	河北
河北省无极县人民法院	河北
河北省吴桥县人民法院	河北
河北省武安市人民法院	河北
河北省武强县人民法院	河北
河北省武邑县人民法院	河北
河北省献县人民法院	河北
河北省香河县人民法院	河北
河北省辛集市人民法院	河北
河北省新河县人民法院	河北
河北省新乐市人民法院	河北
河北省邢台经济开发区人民法院	河北
河北省邢台市桥东区人民法院	河北
河北省邢台市桥西区人民法院	河北
河北省邢台市中级人民法院	河北
河北省邢台县人民法院	河北
河北省兴隆县人民法院	河北
河北省雄县人民法院	河北
河北省宣化县人民法院	河北
河北省盐山县人民法院	河北
河北省阳原县人民法院	河北
河北省易县人民法院	河北
河北省永年县人民法院	河北
河北省永清县人民法院	河北
河北省玉田县人民法院	河北
河北省元氏县人民法院	河北
河北省赞皇县人民法院	河北
河北省枣强县人民法院	河北
河北省张北县人民法院	河北
河北省张家口经济开发区人民法院	河北
河北省张家口市桥东区人民法院	河北
河北省张家口市桥西区人民法院	河北
河北省张家口市下花园区人民法院	河北
河北省张家口市宣化区人民法院	河北
河北省张家口市中级人民法院	河北
河北省赵县人民法院	河北
河北省正定县人民法院	河北
河北省涿鹿县人民法院	河北
河北省涿州市人民法院	河北
河北省遵化市人民法院	河北
河南省安阳市北关区人民法院	河南
河南省安阳市龙安区人民法院	河南
河南省安阳市文峰区人民法院	河南
河南省安阳市殷都区人民法院	河南
河南省安阳市中级人民法院	河南
河南省安阳县人民法院	河南
河南省宝丰县人民法院	河南
河南省博爱县人民法院	河南
河南省郸城县人民法院	河南
河南省登封市人民法院	河南
河南省邓州市人民法院	河南
河南省范县人民法院	河南
河南省方城县人民法院	河南
河南省封丘县人民法院	河南
河南省扶沟县人民法院	河南
河南省高级人民法院	河南
河南省巩义市人民法院	河南
河南省固始县人民法院	河南
河南省光山县人民法院	河南
河南省鹤壁市鹤山区人民法院	河南
河南省鹤壁市淇滨区人民法院	河南
河南省鹤壁市山城区人民法院	河南
河南省鹤壁市中级人民法院	河南
河南省滑县人民法院	河南
河南省淮滨县人民法院	河南
河南省淮阳县人民法院	河南
河南省潢川县人民法院	河南
河南省辉县市人民法院	河南
河南省获嘉县人民法院	河南
河南省济源市人民法院	河南
河南省济源中级人民法院	河南
河南省郏县人民法院	河南
河南省焦作市解放区人民法院	河南
河南省焦作市马村区人民法院	河南
河南省焦作市山阳区人民法院	河南
河南省焦作市中级人民法院	河南
河南省焦作市中站区人民法院	河南
河南省浚县人民法院	河南
河南省开封市鼓楼区人民法院	河南
河南省开封市金明区人民法院	河南
河南省开封市龙亭区人民法院	河南
河南省开封市顺河回族区人民法院	河南
河南省开封市祥符区人民法院	河南
河南省开封市禹王台区人民法院	河南
河南省开封市中级人民法院	河南
河南省兰考县人民法院	河南
河南省林州市人民法院	河南
河南省临颍县人民法院	河南
河南省灵宝市人民法院	河南
河南省卢氏县人民法院	河南
河南省鲁山县人民法院	河南
河南省鹿邑县人民法院	河南
河南省栾川县人民法院	河南
河南省罗山县人民法院	河南
河南省洛宁县人民法院	河南
河南省洛阳高新技术产业开发区人民法院	河南
河南省洛阳市瀍河回族区人民法院	河南
河南省洛阳市吉利区人民法院	河南
河南省洛阳市涧西区人民法院	河南
河南省洛阳市老城区人民法院	河南
河南省洛阳市洛龙区人民法院	河南
河南省洛阳市西工区人民法院	河南
河南省洛阳市中级人民法院	河南
河南省洛阳铁路运输法院	河南
河南省漯河市郾城区人民法院	河南
河南省漯河市源汇区人民法院	河南
河南省漯河市召陵区人民法院	河南
河南省漯河市中级人民法院	河南
河南省孟津县人民法院	河南
河南省孟州市人民法院	河南
河南省泌阳县人民法院	河南
河南省渑池县人民法院	河南
河南省民权县人民法院	河南
河南省南乐县人民法院	河南
河南省南阳市宛城区人民法院	河南
河南省南阳市卧龙区人民法院	河南
河南省南阳市中级人民法院	河南
河南省南召县人民法院	河南
河南省内黄县人民法院	河南
河南省内乡县人民法院	河南
河南省宁陵县人民法院	河南
河南省平顶山市石龙区人民法院	河南
河南省平顶山市卫东区人民法院	河南
河南省平顶山市新华区人民法院	河南
河南省平顶山市湛河区人民法院	河南
河南省平顶山市中级人民法院	河南
河南省平舆县人民法院	河南
河南省濮阳市华龙区人民法院	河南
河南省濮阳市中级人民法院	河南
河南省濮阳县人民法院	河南
河南省淇县人民法院	河南
河南省杞县人民法院	河南
河南省沁阳市人民法院	河南
河南省清丰县人民法院	河南
河南省确山县人民法院	河南
河南省汝南县人民法院	河南
河南省汝阳县人民法院	河南
河南省汝州市人民法院	河南
河南省三门峡市湖滨区人民法院	河南
河南省三门峡市中级人民法院	河南
河南省陕县人民法院	河南
河南省商城县人民法院	河南
河南省商丘市梁园区人民法院	河南
河南省商丘市睢阳区人民法院	河南
河南省商丘市中级人民法院	河南
河南省商水县人民法院	河南
河南省上蔡县人民法院	河南
河南省社旗县人民法院	河南
河南省沈丘县人民法院	河南
河南省嵩县人民法院	河南
河南省睢县人民法院	河南
河南省遂平县人民法院	河南
河南省台前县人民法院	河南
河南省太康县人民法院	河南
河南省汤阴县人民法院	河南
河南省唐河县人民法院	河南
河南省通许县人民法院	河南
河南省桐柏县人民法院	河南
河南省卫辉市人民法院	河南
河南省尉氏县人民法院	河南
河南省温县人民法院	河南
河南省武陟县人民法院	河南
河南省舞钢市人民法院	河南
河南省舞阳县人民法院	河南
河南省西华县人民法院	河南
河南省西平县人民法院	河南
河南省西峡县人民法院	河南
河南省息县人民法院	河南
河南省淅川县人民法院	河南
河南省夏邑县人民法院	河南
河南省襄城县人民法院	河南
河南省项城市人民法院	河南
河南省新安县人民法院	河南
河南省新蔡县人民法院	河南
河南省新密市人民法院	河南
河南省新县人民法院	河南
河南省新乡市凤泉区人民法院	河南
河南省新乡市红旗区人民法院	河南
河南省新乡市牧野区人民法院	河南
河南省新乡市卫滨区人民法院	河南
河南省新乡市中级人民法院	河南
河南省新乡县人民法院	河南
河南省新野县人民法院	河南
河南省新郑市人民法院	河南
河南省信阳市平桥区人民法院	河南
河南省信阳市浉河区人民法院	河南
河南省信阳市中级人民法院	河南
河南省修武县人民法院	河南
河南省许昌市魏都区人民法院	河南
河南省许昌市中级人民法院	河南
河南省许昌县人民法院	河南
河南省鄢陵县人民法院	河南
河南省延津县人民法院	河南
河南省偃师市人民法院	河南
河南省叶县人民法院	河南
河南省伊川县人民法院	河南
河南省宜阳县人民法院	河南
河南省义马市人民法院	河南
河南省荥阳市人民法院	河南
河南省永城市人民法院	河南
河南省虞城县人民法院	河南
河南省禹州市人民法院	河南
河南省原阳县人民法院	河南
河南省长葛市人民法院	河南
河南省长垣县人民法院	河南
河南省柘城县人民法院	河南
河南省镇平县人民法院	河南
河南省正阳县人民法院	河南
河南省郑州高新技术产业开发区人民法院	河南
河南省郑州航空港经济综合实验区人民法院	河南
河南省郑州市二七区人民法院	河南
河南省郑州市管城回族区人民法院	河南
河南省郑州市惠济区人民法院	河南
河南省郑州市金水区人民法院	河南
河南省郑州市上街区人民法院	河南
河南省郑州市中级人民法院	河南
河南省郑州市中原区人民法院	河南
河南省郑州铁路运输法院	河南
河南省郑州铁路运输中级法院	河南
河南省中牟县人民法院	河南
河南省周口市川汇区人民法院	河南
河南省周口市中级人民法院	河南
河南省驻马店市驿城区人民法院	河南
河南省驻马店市中级人民法院	河南
黑龙江省阿木尔林区基层法院	黑龙江
黑龙江省安达市人民法院	黑龙江
黑龙江省八面通林区基层法院	黑龙江
黑龙江省巴彦县人民法院	黑龙江
黑龙江省拜泉县人民法院	黑龙江
黑龙江省宝清县人民法院	黑龙江
黑龙江省宝泉岭农垦法院	黑龙江
黑龙江省北安农垦法院	黑龙江
黑龙江省北安市人民法院	黑龙江
黑龙江省宾县人民法院	黑龙江
黑龙江省勃利县人民法院	黑龙江
黑龙江省柴河林区基层法院	黑龙江
黑龙江省大海林林区基层法院	黑龙江
黑龙江省大庆高新技术产业开发区人民法院	黑龙江
黑龙江省大庆市大同区人民法院	黑龙江
黑龙江省大庆市红岗区人民法院	黑龙江
黑龙江省大庆市龙凤区人民法院	黑龙江
黑龙江省大庆市让胡路区人民法院	黑龙江
黑龙江省大庆市萨尔图区人民法院	黑龙江
黑龙江省大庆市中级人民法院	黑龙江
黑龙江省大兴安岭地区呼中区人民法院	黑龙江
黑龙江省大兴安岭地区加格达奇区人民法院	黑龙江
黑龙江省大兴安岭地区松岭区人民法院	黑龙江
黑龙江省大兴安岭地区新林区人民法院	黑龙江
黑龙江省大兴安岭地区中级人民法院	黑龙江
黑龙江省东方红林区基层法院	黑龙江
黑龙江省东京城林区基层法院	黑龙江
黑龙江省东宁县人民法院	黑龙江
黑龙江省杜尔伯特蒙古族自治县人民法院	黑龙江
黑龙江省方正林区基层法院	黑龙江
黑龙江省方正县人民法院	黑龙江
黑龙江省抚远县人民法院	黑龙江
黑龙江省富锦市人民法院	黑龙江
黑龙江省富裕县人民法院	黑龙江
黑龙江省甘南县人民法院	黑龙江
黑龙江省高级人民法院	黑龙江
黑龙江省哈尔滨市阿城区人民法院	黑龙江
黑龙江省哈尔滨市道里区人民法院	黑龙江
黑龙江省哈尔滨市道外区人民法院	黑龙江
黑龙江省哈尔滨市呼兰区人民法院	黑龙江
黑龙江省哈尔滨市南岗区人民法院	黑龙江
黑龙江省哈尔滨市平房区人民法院	黑龙江
黑龙江省哈尔滨市双城区人民法院	黑龙江
黑龙江省哈尔滨市松北区人民法院	黑龙江
黑龙江省哈尔滨市香坊区人民法院	黑龙江
黑龙江省哈尔滨市中级人民法院	黑龙江
黑龙江省哈尔滨铁路运输法院	黑龙江
黑龙江省哈尔滨铁路运输中级法院	黑龙江
黑龙江省海林林区基层法院	黑龙江
黑龙江省海林市人民法院	黑龙江
黑龙江省海伦市人民法院	黑龙江
黑龙江省鹤北林区基层法院	黑龙江
黑龙江省鹤岗市东山区人民法院	黑龙江
黑龙江省鹤岗市工农区人民法院	黑龙江
黑龙江省鹤岗市南山区人民法院	黑龙江
黑龙江省鹤岗市向阳区人民法院	黑龙江
黑龙江省鹤岗市兴安区人民法院	黑龙江
黑龙江省鹤岗市兴山区人民法院	黑龙江
黑龙江省鹤岗市中级人民法院	黑龙江
黑龙江省鹤立林区基层法院	黑龙江
黑龙江省黑河市爱辉区人民法院	黑龙江
黑龙江省黑河市中级人民法院	黑龙江
黑龙江省黑龙江省林区中级人民法院	黑龙江
黑龙江省黑龙江省农垦中级法院	黑龙江
黑龙江省红兴隆农垦法院	黑龙江
黑龙江省呼玛县人民法院	黑龙江
黑龙江省虎林市人民法院	黑龙江
黑龙江省桦川县人民法院	黑龙江
黑龙江省桦南林区基层法院	黑龙江
黑龙江省桦南县人民法院	黑龙江
黑龙江省鸡东县人民法院	黑龙江
黑龙江省鸡西市城子河区人民法院	黑龙江
黑龙江省鸡西市滴道区人民法院	黑龙江
黑龙江省鸡西市恒山区人民法院	黑龙江
黑龙江省鸡西市鸡冠区人民法院	黑龙江
黑龙江省鸡西市梨树区人民法院	黑龙江
黑龙江省鸡西市麻山区人民法院	黑龙江
黑龙江省鸡西市中级人民法院	黑龙江
黑龙江省集贤县人民法院	黑龙江
黑龙江省佳木斯市东风区人民法院	黑龙江
黑龙江省佳木斯市郊区人民法院	黑龙江
黑龙江省佳木斯市前进区人民法院	黑龙江
黑龙江省佳木斯市向阳区人民法院	黑龙江
黑龙江省佳木斯市中级人民法院	黑龙江
黑龙江省佳木斯铁路运输法院	黑龙江
黑龙江省嘉荫县人民法院	黑龙江
黑龙江省建三江农垦法院	黑龙江
黑龙江省九三农垦法院	黑龙江
黑龙江省克东县人民法院	黑龙江
黑龙江省克山县人民法院	黑龙江
黑龙江省兰西县人民法院	黑龙江
黑龙江省朗乡林区基层法院	黑龙江
黑龙江省林甸县人民法院	黑龙江
黑龙江省林口林区基层法院	黑龙江
黑龙江省林口县人民法院	黑龙江
黑龙江省龙江县人民法院	黑龙江
黑龙江省萝北县人民法院	黑龙江
黑龙江省密山市人民法院	黑龙江
黑龙江省明水县人民法院	黑龙江
黑龙江省漠河县人民法院	黑龙江
黑龙江省牡丹江农垦法院	黑龙江
黑龙江省牡丹江市爱民区人民法院	黑龙江
黑龙江省牡丹江市东安区人民法院	黑龙江
黑龙江省牡丹江市西安区人民法院	黑龙江
黑龙江省牡丹江市阳明区人民法院	黑龙江
黑龙江省牡丹江市中级人民法院	黑龙江
黑龙江省牡丹江铁路运输法院	黑龙江
黑龙江省木兰县人民法院	黑龙江
黑龙江省穆棱林区基层法院	黑龙江
黑龙江省穆棱市人民法院	黑龙江
黑龙江省讷河市人民法院	黑龙江
黑龙江省嫩江县人民法院	黑龙江
黑龙江省宁安市人民法院	黑龙江
黑龙江省七台河市茄子河区人民法院	黑龙江
黑龙江省七台河市桃山区人民法院	黑龙江
黑龙江省七台河市新兴区人民法院	黑龙江
黑龙江省七台河市中级人民法院	黑龙江
黑龙江省齐齐哈尔农垦法院	黑龙江
黑龙江省齐齐哈尔市昂昂溪区人民法院	黑龙江
黑龙江省齐齐哈尔市富拉尔基区人民法院	黑龙江
黑龙江省齐齐哈尔市建华区人民法院	黑龙江
黑龙江省齐齐哈尔市龙沙区人民法院	黑龙江
黑龙江省齐齐哈尔市梅里斯达斡尔族区人民法院	黑龙江
黑龙江省齐齐哈尔市碾子山区人民法院	黑龙江
黑龙江省齐齐哈尔市铁锋区人民法院	黑龙江
黑龙江省齐齐哈尔市中级人民法院	黑龙江
黑龙江省齐齐哈尔铁路运输法院	黑龙江
黑龙江省青冈县人民法院	黑龙江
黑龙江省清河林区基层法院	黑龙江
黑龙江省庆安县人民法院	黑龙江
黑龙江省饶河县人民法院	黑龙江
黑龙江省山河屯林区基层法院	黑龙江
黑龙江省尚志市人民法院	黑龙江
黑龙江省十八站林区基层法院	黑龙江
黑龙江省双丰林区基层法院	黑龙江
黑龙江省双鸭山林区基层法院	黑龙江
黑龙江省双鸭山市宝山区人民法院	黑龙江
黑龙江省双鸭山市尖山区人民法院	黑龙江
黑龙江省双鸭山市岭东区人民法院	黑龙江
黑龙江省双鸭山市四方台区人民法院	黑龙江
黑龙江省双鸭山市中级人民法院	黑龙江
黑龙江省绥滨县人民法院	黑龙江
黑龙江省绥芬河市人民法院	黑龙江
黑龙江省绥化农垦法院	黑龙江
黑龙江省绥化市北林区人民法院	黑龙江
黑龙江省绥化市中级人民法院	黑龙江
黑龙江省绥棱林区基层法院	黑龙江
黑龙江省绥棱县人民法院	黑龙江
黑龙江省绥阳林区基层法院	黑龙江
黑龙江省孙吴县人民法院	黑龙江
黑龙江省塔河县人民法院	黑龙江
黑龙江省泰来县人民法院	黑龙江
黑龙江省汤原县人民法院	黑龙江
黑龙江省桃山林区基层法院	黑龙江
黑龙江省铁力林区基层法院	黑龙江
黑龙江省铁力市人民法院	黑龙江
黑龙江省通北林区基层法院	黑龙江
黑龙江省通河县人民法院	黑龙江
黑龙江省同江市人民法院	黑龙江
黑龙江省图强林区基层法院	黑龙江
黑龙江省望奎县人民法院	黑龙江
黑龙江省苇河林区基层法院	黑龙江
黑龙江省五常市人民法院	黑龙江
黑龙江省五大连池市人民法院	黑龙江
黑龙江省兴隆林区基层法院	黑龙江
黑龙江省逊克县人民法院	黑龙江
黑龙江省亚布力林区基层法院	黑龙江
黑龙江省延寿县人民法院	黑龙江
黑龙江省伊春市翠峦区人民法院	黑龙江
黑龙江省伊春市带岭区人民法院	黑龙江
黑龙江省伊春市红星区人民法院	黑龙江
黑龙江省伊春市金山屯区人民法院	黑龙江
黑龙江省伊春市美溪区人民法院	黑龙江
黑龙江省伊春市南岔区人民法院	黑龙江
黑龙江省伊春市上甘岭区人民法院	黑龙江
黑龙江省伊春市汤旺河区人民法院	黑龙江
黑龙江省伊春市乌马河区人民法院	黑龙江
黑龙江省伊春市乌伊岭区人民法院	黑龙江
黑龙江省伊春市五营区人民法院	黑龙江
黑龙江省伊春市西林区人民法院	黑龙江
黑龙江省伊春市新青区人民法院	黑龙江
黑龙江省伊春市伊春区人民法院	黑龙江
黑龙江省伊春市友好区人民法院	黑龙江
黑龙江省伊春市中级人民法院	黑龙江
黑龙江省依安县人民法院	黑龙江
黑龙江省依兰县人民法院	黑龙江
黑龙江省迎春林区基层法院	黑龙江
黑龙江省友谊县人民法院	黑龙江
黑龙江省沾河林区基层法院	黑龙江
黑龙江省肇东市人民法院	黑龙江
黑龙江省肇源县人民法院	黑龙江
黑龙江省肇州县人民法院	黑龙江
湖北省安陆市人民法院	湖北
湖北省巴东县人民法院	湖北
湖北省保康县人民法院	湖北
湖北省赤壁市人民法院	湖北
湖北省崇阳县人民法院	湖北
湖北省大悟县人民法院	湖北
湖北省大冶市人民法院	湖北
湖北省丹江口市人民法院	湖北
湖北省当阳市人民法院	湖北
湖北省鄂州市鄂城区人民法院	湖北
湖北省鄂州市华容区人民法院	湖北
湖北省鄂州市梁子湖区人民法院	湖北
湖北省鄂州市中级人民法院	湖北
湖北省恩施市人民法院	湖北
湖北省恩施土家族苗族自治州中级人民法院	湖北
湖北省房县人民法院	湖北
湖北省高级人民法院	湖北
湖北省葛洲坝人民法院	湖北
湖北省公安县人民法院	湖北
湖北省谷城县人民法院	湖北
湖北省广水市人民法院	湖北
湖北省汉川市人民法院	湖北
湖北省鹤峰县人民法院	湖北
湖北省红安县人民法院	湖北
湖北省洪湖市人民法院	湖北
湖北省湖北省汉江中级人民法院	湖北
湖北省湖北省沙洋人民法院	湖北
湖北省黄冈市黄州区人民法院	湖北
湖北省黄冈市中级人民法院	湖北
湖北省黄梅县人民法院	湖北
湖北省黄石市黄石港区人民法院	湖北
湖北省黄石市铁山区人民法院	湖北
湖北省黄石市西塞山区人民法院	湖北
湖北省黄石市下陆区人民法院	湖北
湖北省黄石市中级人民法院	湖北
湖北省嘉鱼县人民法院	湖北
湖北省监利县人民法院	湖北
湖北省建始县人民法院	湖北
湖北省江陵县人民法院	湖北
湖北省京山县人民法院	湖北
湖北省荆门市东宝区人民法院	湖北
湖北省荆门市掇刀区人民法院	湖北
湖北省荆门市中级人民法院	湖北
湖北省荆州市荆州区人民法院	湖北
湖北省荆州市沙市区人民法院	湖北
湖北省荆州市中级人民法院	湖北
湖北省来凤县人民法院	湖北
湖北省老河口市人民法院	湖北
湖北省利川市人民法院	湖北
湖北省罗田县人民法院	湖北
湖北省麻城市人民法院	湖北
湖北省南漳县人民法院	湖北
湖北省蕲春县人民法院	湖北
湖北省潜江市人民法院	湖北
湖北省沙洋人民法院	湖北
湖北省沙洋县人民法院	湖北
湖北省神农架林区人民法院	湖北
湖北省十堰市茅箭区人民法院	湖北
湖北省十堰市郧阳区人民法院	湖北
湖北省十堰市张湾区人民法院	湖北
湖北省十堰市中级人民法院	湖北
湖北省石首市人民法院	湖北
湖北省松滋市人民法院	湖北
湖北省随县人民法院	湖北
湖北省随州市曾都区人民法院	湖北
湖北省随州市中级人民法院	湖北
湖北省天门市人民法院	湖北
湖北省通城县人民法院	湖北
湖北省通山县人民法院	湖北
湖北省团风县人民法院	湖北
湖北省五峰土家族自治县人民法院	湖北
湖北省武汉东湖新技术开发区人民法院	湖北
湖北省武汉海事法院	湖北
湖北省武汉经济技术开发区人民法院	湖北
湖北省武汉市蔡甸区人民法院	湖北
湖北省武汉市东西湖区人民法院	湖北
湖北省武汉市汉南区人民法院	湖北
湖北省武汉市汉阳区人民法院	湖北
湖北省武汉市洪山区人民法院	湖北
湖北省武汉市黄陂区人民法院	湖北
湖北省武汉市江岸区人民法院	湖北
湖北省武汉市江汉区人民法院	湖北
湖北省武汉市江夏区人民法院	湖北
湖北省武汉市硚口区人民法院	湖北
湖北省武汉市青山区人民法院	湖北
湖北省武汉市武昌区人民法院	湖北
湖北省武汉市新洲区人民法院	湖北
湖北省武汉市中级人民法院	湖北
湖北省武汉铁路运输法院	湖北
湖北省武汉铁路运输中级法院	湖北
湖北省武穴市人民法院	湖北
湖北省浠水县人民法院	湖北
湖北省仙桃市人民法院	湖北
湖北省咸丰县人民法院	湖北
湖北省咸宁市咸安区人民法院	湖北
湖北省咸宁市中级人民法院	湖北
湖北省襄阳高新技术产业开发区人民法院	湖北
湖北省襄阳市樊城区人民法院	湖北
湖北省襄阳市襄城区人民法院	湖北
湖北省襄阳市襄州区人民法院	湖北
湖北省襄阳市中级人民法院	湖北
湖北省襄阳铁路运输法院	湖北
湖北省孝昌县人民法院	湖北
湖北省孝感市孝南区人民法院	湖北
湖北省孝感市中级人民法院	湖北
湖北省兴山县人民法院	湖北
湖北省宣恩县人民法院	湖北
湖北省阳新县人民法院	湖北
湖北省宜昌市点军区人民法院	湖北
湖北省宜昌市三峡坝区人民法院	湖北
湖北省宜昌市伍家岗区人民法院	湖北
湖北省宜昌市西陵区人民法院	湖北
湖北省宜昌市猇亭区人民法院	湖北
湖北省宜昌市夷陵区人民法院	湖北
湖北省宜昌市中级人民法院	湖北
湖北省宜城市人民法院	湖北
湖北省宜都市人民法院	湖北
湖北省英山县人民法院	湖北
湖北省应城市人民法院	湖北
湖北省远安县人民法院	湖北
湖北省云梦县人民法院	湖北
湖北省郧西县人民法院	湖北
湖北省枣阳市人民法院	湖北
湖北省长阳土家族自治县人民法院	湖北
湖北省枝江市人民法院	湖北
湖北省钟祥市人民法院	湖北
湖北省竹山县人民法院	湖北
湖北省竹溪县人民法院	湖北
湖北省秭归县人民法院	湖北
湖南省安化县人民法院	湖南
湖南省安仁县人民法院	湖南
湖南省安乡县人民法院	湖南
湖南省保靖县人民法院	湖南
湖南省茶陵县人民法院	湖南
湖南省常德市鼎城区人民法院	湖南
湖南省常德市武陵区人民法院	湖南
湖南省常德市中级人民法院	湖南
湖南省常宁市人民法院	湖南
湖南省郴州市北湖区人民法院	湖南
湖南省郴州市苏仙区人民法院	湖南
湖南省郴州市中级人民法院	湖南
湖南省辰溪县人民法院	湖南
湖南省城步苗族自治县人民法院	湖南
湖南省慈利县人民法院	湖南
湖南省大通湖管理区人民法院	湖南
湖南省道县人民法院	湖南
湖南省东安县人民法院	湖南
湖南省洞口县人民法院	湖南
湖南省凤凰县人民法院	湖南
湖南省高级人民法院	湖南
湖南省古丈县人民法院	湖南
湖南省桂东县人民法院	湖南
湖南省桂阳县人民法院	湖南
湖南省汉寿县人民法院	湖南
湖南省衡东县人民法院	湖南
湖南省衡南县人民法院	湖南
湖南省衡山县人民法院	湖南
湖南省衡阳市南岳区人民法院	湖南
湖南省衡阳市石鼓区人民法院	湖南
湖南省衡阳市雁峰区人民法院	湖南
湖南省衡阳市蒸湘区人民法院	湖南
湖南省衡阳市中级人民法院	湖南
湖南省衡阳市珠晖区人民法院	湖南
湖南省衡阳铁路运输法院	湖南
湖南省衡阳县人民法院	湖南
湖南省洪江人民法院	湖南
湖南省洪江市人民法院	湖南
湖南省花垣县人民法院	湖南
湖南省华容县人民法院	湖南
湖南省怀化市鹤城区人民法院	湖南
湖南省怀化市中级人民法院	湖南
湖南省怀化铁路运输法院	湖南
湖南省会同县人民法院	湖南
湖南省吉首市人民法院	湖南
湖南省嘉禾县人民法院	湖南
湖南省江华瑶族自治县人民法院	湖南
湖南省江永县人民法院	湖南
湖南省津市市人民法院	湖南
湖南省靖州苗族侗族自治县人民法院	湖南
湖南省蓝山县人民法院	湖南
湖南省耒阳市人民法院	湖南
湖南省冷水江市人民法院	湖南
湖南省澧县人民法院	湖南
湖南省醴陵市人民法院	湖南
湖南省涟源市人民法院	湖南
湖南省临澧县人民法院	湖南
湖南省临武县人民法院	湖南
湖南省临湘市人民法院	湖南
湖南省浏阳市人民法院	湖南
湖南省龙山县人民法院	湖南
湖南省隆回县人民法院	湖南
湖南省娄底市娄星区人民法院	湖南
湖南省娄底市中级人民法院	湖南
湖南省泸溪县人民法院	湖南
湖南省麻阳苗族自治县人民法院	湖南
湖南省汨罗市人民法院	湖南
湖南省南县人民法院	湖南
湖南省宁乡县人民法院	湖南
湖南省宁远县人民法院	湖南
湖南省平江县人民法院	湖南
湖南省祁东县人民法院	湖南
湖南省祁阳县人民法院	湖南
湖南省屈原管理区人民法院	湖南
湖南省汝城县人民法院	湖南
湖南省桑植县人民法院	湖南
湖南省韶山市人民法院	湖南
湖南省邵东县人民法院	湖南
湖南省邵阳市北塔区人民法院	湖南
湖南省邵阳市大祥区人民法院	湖南
湖南省邵阳市双清区人民法院	湖南
湖南省邵阳市中级人民法院	湖南
湖南省邵阳县人民法院	湖南
湖南省石门县人民法院	湖南
湖南省双峰县人民法院	湖南
湖南省双牌县人民法院	湖南
湖南省绥宁县人民法院	湖南
湖南省桃江县人民法院	湖南
湖南省桃源县人民法院	湖南
湖南省通道侗族自治县人民法院	湖南
湖南省武冈市人民法院	湖南
湖南省湘潭市雨湖区人民法院	湖南
湖南省湘潭市岳塘区人民法院	湖南
湖南省湘潭市中级人民法院	湖南
湖南省湘潭县人民法院	湖南
湖南省湘西土家族苗族自治州中级人民法院	湖南
湖南省湘乡市人民法院	湖南
湖南省湘阴县人民法院	湖南
湖南省新化县人民法院	湖南
湖南省新晃侗族自治县人民法院	湖南
湖南省新宁县人民法院	湖南
湖南省新邵县人民法院	湖南
湖南省新田县人民法院	湖南
湖南省溆浦县人民法院	湖南
湖南省炎陵县人民法院	湖南
湖南省宜章县人民法院	湖南
湖南省益阳市赫山区人民法院	湖南
湖南省益阳市中级人民法院	湖南
湖南省益阳市资阳区人民法院	湖南
湖南省永顺县人民法院	湖南
湖南省永兴县人民法院	湖南
湖南省永州市冷水滩区人民法院	湖南
湖南省永州市零陵区人民法院	湖南
湖南省永州市中级人民法院	湖南
湖南省攸县人民法院	湖南
湖南省沅江市人民法院	湖南
湖南省沅陵县人民法院	湖南
湖南省岳阳市君山区人民法院	湖南
湖南省岳阳市岳阳楼区人民法院	湖南
湖南省岳阳市云溪区人民法院	湖南
湖南省岳阳市中级人民法院	湖南
湖南省岳阳县人民法院	湖南
湖南省张家界市武陵源区人民法院	湖南
湖南省张家界市永定区人民法院	湖南
湖南省张家界市中级人民法院	湖南
湖南省长沙市芙蓉区人民法院	湖南
湖南省长沙市开福区人民法院	湖南
湖南省长沙市天心区人民法院	湖南
湖南省长沙市望城区人民法院	湖南
湖南省长沙市雨花区人民法院	湖南
湖南省长沙市岳麓区人民法院	湖南
湖南省长沙市中级人民法院	湖南
湖南省长沙铁路运输法院	湖南
湖南省长沙县人民法院	湖南
湖南省芷江侗族自治县人民法院	湖南
湖南省中方县人民法院	湖南
湖南省株洲市荷塘区人民法院	湖南
湖南省株洲市芦淞区人民法院	湖南
湖南省株洲市石峰区人民法院	湖南
湖南省株洲市天元区人民法院	湖南
湖南省株洲市中级人民法院	湖南
湖南省株洲县人民法院	湖南
湖南省资兴市人民法院	湖南
吉林省安图县人民法院	吉林
吉林省白城市洮北区人民法院	吉林
吉林省白城市中级人民法院	吉林
吉林省白城铁路运输法院	吉林
吉林省白河林区基层法院	吉林
吉林省白山市浑江区人民法院	吉林
吉林省白山市江源区人民法院	吉林
吉林省白山市中级人民法院	吉林
吉林省白石山林区基层法院	吉林
吉林省大安市人民法院	吉林
吉林省德惠市人民法院	吉林
吉林省东丰县人民法院	吉林
吉林省东辽县人民法院	吉林
吉林省敦化林区基层法院	吉林
吉林省敦化市人民法院	吉林
吉林省扶余市人民法院	吉林
吉林省抚松林区基层法院	吉林
吉林省抚松县人民法院	吉林
吉林省高级人民法院	吉林
吉林省公主岭市人民法院	吉林
吉林省和龙林区基层法院	吉林
吉林省和龙市人民法院	吉林
吉林省红石林区基层法院	吉林
吉林省桦甸市人民法院	吉林
吉林省珲春林区基层法院	吉林
吉林省珲春市人民法院	吉林
吉林省辉南县人民法院	吉林
吉林省吉林高新技术产业开发区人民法院	吉林
吉林省吉林市昌邑区人民法院	吉林
吉林省吉林市船营区人民法院	吉林
吉林省吉林市丰满区人民法院	吉林
吉林省吉林市龙潭区人民法院	吉林
吉林省吉林市中级人民法院	吉林
吉林省吉林铁路运输法院	吉林
吉林省集安市人民法院	吉林
吉林省江源林区基层法院	吉林
吉林省蛟河市人民法院	吉林
吉林省靖宇县人民法院	吉林
吉林省九台市人民法院	吉林
吉林省梨树县人民法院	吉林
吉林省辽源市龙山区人民法院	吉林
吉林省辽源市西安区人民法院	吉林
吉林省辽源市中级人民法院	吉林
吉林省临江林区基层法院	吉林
吉林省临江市人民法院	吉林
吉林省柳河县人民法院	吉林
吉林省龙井市人民法院	吉林
吉林省梅河口市人民法院	吉林
吉林省农安县人民法院	吉林
吉林省磐石市人民法院	吉林
吉林省前郭尔罗斯蒙古族自治县人民法院	吉林
吉林省乾安县人民法院	吉林
吉林省舒兰市人民法院	吉林
吉林省双辽市人民法院	吉林
吉林省四平市铁东区人民法院	吉林
吉林省四平市铁西区人民法院	吉林
吉林省四平市中级人民法院	吉林
吉林省松原市宁江区人民法院	吉林
吉林省松原市中级人民法院	吉林
吉林省洮南市人民法院	吉林
吉林省通化市东昌区人民法院	吉林
吉林省通化市二道江区人民法院	吉林
吉林省通化市中级人民法院	吉林
吉林省通化铁路运输法院	吉林
吉林省通化县人民法院	吉林
吉林省通榆县人民法院	吉林
吉林省图们市人民法院	吉林
吉林省图们铁路运输法院	吉林
吉林省汪清林区基层法院	吉林
吉林省汪清县人民法院	吉林
吉林省延边朝鲜族自治州中级人民法院	吉林
吉林省延边林区中级法院	吉林
吉林省延吉市人民法院	吉林
吉林省伊通满族自治县人民法院	吉林
吉林省永吉县人民法院	吉林
吉林省榆树市人民法院	吉林
吉林省长白朝鲜族自治县人民法院	吉林
吉林省长春高新技术产业开发区人民法院	吉林
吉林省长春经济技术开发区人民法院	吉林
吉林省长春净月高新技术产业开发区人民法院	吉林
吉林省长春林区中级法院	吉林
吉林省长春汽车经济技术开发区人民法院	吉林
吉林省长春市朝阳区人民法院	吉林
吉林省长春市二道区人民法院	吉林
吉林省长春市九台区人民法院	吉林
吉林省长春市宽城区人民法院	吉林
吉林省长春市绿园区人民法院	吉林
吉林省长春市南关区人民法院	吉林
吉林省长春市双阳区人民法院	吉林
吉林省长春市中级人民法院	吉林
吉林省长春铁路运输法院	吉林
吉林省长春铁路运输中级法院	吉林
吉林省长岭县人民法院	吉林
吉林省镇赉县人民法院	吉林
江苏省宝应县人民法院	江苏
江苏省滨海县人民法院	江苏
江苏省常熟市人民法院	江苏
江苏省常州高新技术产业开发区人民法院	江苏
江苏省常州经济开发区人民法院	江苏
江苏省常州市金坛区人民法院	江苏
江苏省常州市戚墅堰区人民法院	江苏
江苏省常州市天宁区人民法院	江苏
江苏省常州市武进区人民法院	江苏
江苏省常州市新北区人民法院	江苏
江苏省常州市中级人民法院	江苏
江苏省常州市钟楼区人民法院	江苏
江苏省大丰市人民法院	江苏
江苏省丹阳市人民法院	江苏
江苏省东海县人民法院	江苏
江苏省东台市人民法院	江苏
江苏省丰县人民法院	江苏
江苏省阜宁县人民法院	江苏
江苏省高级人民法院	江苏
江苏省高邮市人民法院	江苏
江苏省灌南县人民法院	江苏
江苏省灌云县人民法院	江苏
江苏省海安县人民法院	江苏
江苏省海门市人民法院	江苏
江苏省洪泽县人民法院	江苏
江苏省淮安经济技术开发区人民法院	江苏
江苏省淮安市淮安区人民法院	江苏
江苏省淮安市淮阴区人民法院	江苏
江苏省淮安市清河区人民法院	江苏
江苏省淮安市清浦区人民法院	江苏
江苏省淮安市中级人民法院	江苏
江苏省建湖县人民法院	江苏
江苏省江宁经济技术开发区人民法院	江苏
江苏省江阴市人民法院	江苏
江苏省金湖县人民法院	江苏
江苏省金坛市人民法院	江苏
江苏省靖江市人民法院	江苏
江苏省句容市人民法院	江苏
江苏省昆山市人民法院	江苏
江苏省溧阳市人民法院	江苏
江苏省连云港经济技术开发区人民法院	江苏
江苏省连云港市赣榆区人民法院	江苏
江苏省连云港市海州区人民法院	江苏
江苏省连云港市连云区人民法院	江苏
江苏省连云港市中级人民法院	江苏
江苏省涟水县人民法院	江苏
江苏省南京经济技术开发区人民法院	江苏
江苏省南京市高淳区人民法院	江苏
江苏省南京市鼓楼区人民法院	江苏
江苏省南京市建邺区人民法院	江苏
江苏省南京市江宁区人民法院	江苏
江苏省南京市溧水区人民法院	江苏
江苏省南京市六合区人民法院	江苏
江苏省南京市浦口区人民法院	江苏
江苏省南京市栖霞区人民法院	江苏
江苏省南京市秦淮区人民法院	江苏
江苏省南京市玄武区人民法院	江苏
江苏省南京市雨花台区人民法院	江苏
江苏省南京市中级人民法院	江苏
江苏省南京铁路运输法院	江苏
江苏省南通经济技术开发区人民法院	江苏
江苏省南通市崇川区人民法院	江苏
江苏省南通市港闸区人民法院	江苏
江苏省南通市通州区人民法院	江苏
江苏省南通市中级人民法院	江苏
江苏省沛县人民法院	江苏
江苏省邳州市人民法院	江苏
江苏省启东市人民法院	江苏
江苏省如东县人民法院	江苏
江苏省如皋市人民法院	江苏
江苏省射阳县人民法院	江苏
江苏省沭阳县人民法院	江苏
江苏省泗洪县人民法院	江苏
江苏省泗阳县人民法院	江苏
江苏省苏州工业园区人民法院	江苏
江苏省苏州市姑苏区人民法院	江苏
江苏省苏州市虎丘区人民法院	江苏
江苏省苏州市吴江区人民法院	江苏
江苏省苏州市吴中区人民法院	江苏
江苏省苏州市相城区人民法院	江苏
江苏省苏州市中级人民法院	江苏
江苏省睢宁县人民法院	江苏
江苏省太仓市人民法院	江苏
江苏省泰兴市人民法院	江苏
江苏省泰州市高港区人民法院	江苏
江苏省泰州市海陵区人民法院	江苏
江苏省泰州市姜堰区人民法院	江苏
江苏省泰州市中级人民法院	江苏
江苏省泰州医药高新技术产业开发区人民法院	江苏
江苏省无锡高新技术产业开发区人民法院	江苏
江苏省无锡市北塘区人民法院	江苏
江苏省无锡市滨湖区人民法院	江苏
江苏省无锡市崇安区人民法院	江苏
江苏省无锡市惠山区人民法院	江苏
江苏省无锡市梁溪区人民法院	江苏
江苏省无锡市南长区人民法院	江苏
江苏省无锡市锡山区人民法院	江苏
江苏省无锡市新吴区人民法院	江苏
江苏省无锡市中级人民法院	江苏
江苏省响水县人民法院	江苏
江苏省新沂市人民法院	江苏
江苏省兴化市人民法院	江苏
江苏省宿迁市宿城区人民法院	江苏
江苏省宿迁市宿豫区人民法院	江苏
江苏省宿迁市中级人民法院	江苏
江苏省盱眙县人民法院	江苏
江苏省徐州经济技术开发区人民法院	江苏
江苏省徐州市鼓楼区人民法院	江苏
江苏省徐州市贾汪区人民法院	江苏
江苏省徐州市泉山区人民法院	江苏
江苏省徐州市铜山区人民法院	江苏
江苏省徐州市云龙区人民法院	江苏
江苏省徐州市中级人民法院	江苏
江苏省徐州铁路运输法院	江苏
江苏省盐城经济技术开发区人民法院	江苏
江苏省盐城市大丰区人民法院	江苏
江苏省盐城市亭湖区人民法院	江苏
江苏省盐城市盐都区人民法院	江苏
江苏省盐城市中级人民法院	江苏
江苏省扬中市人民法院	江苏
江苏省扬州经济技术开发区人民法院	江苏
江苏省扬州市广陵区人民法院	江苏
江苏省扬州市邗江区人民法院	江苏
江苏省扬州市江都区人民法院	江苏
江苏省扬州市中级人民法院	江苏
江苏省仪征市人民法院	江苏
江苏省宜兴市人民法院	江苏
江苏省张家港市人民法院	江苏
江苏省镇江经济开发区人民法院	江苏
江苏省镇江市丹徒区人民法院	江苏
江苏省镇江市京口区人民法院	江苏
江苏省镇江市润州区人民法院	江苏
江苏省镇江市中级人民法院	江苏
江西省安福县人民法院	江西
江西省安义县人民法院	江西
江西省安远县人民法院	江西
江西省崇仁县人民法院	江西
江西省崇义县人民法院	江西
江西省大余县人民法院	江西
江西省德安县人民法院	江西
江西省德兴市人民法院	江西
江西省定南县人民法院	江西
江西省东乡县人民法院	江西
江西省都昌县人民法院	江西
江西省分宜县人民法院	江西
江西省丰城市人民法院	江西
江西省奉新县人民法院	江西
江西省浮梁县人民法院	江西
江西省抚州市临川区人民法院	江西
江西省抚州市中级人民法院	江西
江西省赣县人民法院	江西
江西省赣州经济技术开发区人民法院	江西
江西省赣州市南康区人民法院	江西
江西省赣州市章贡区人民法院	江西
江西省赣州市中级人民法院	江西
江西省高安市人民法院	江西
江西省高级人民法院	江西
江西省共青城市人民法院	江西
江西省广昌县人民法院	江西
江西省贵溪市人民法院	江西
江西省横峰县人民法院	江西
江西省湖口县人民法院	江西
江西省会昌县人民法院	江西
江西省吉安市吉州区人民法院	江西
江西省吉安市青原区人民法院	江西
江西省吉安市中级人民法院	江西
江西省吉安县人民法院	江西
江西省吉水县人民法院	江西
江西省金溪县人民法院	江西
江西省进贤县人民法院	江西
江西省井冈山市人民法院	江西
江西省景德镇市昌江区人民法院	江西
江西省景德镇市中级人民法院	江西
江西省景德镇市珠山区人民法院	江西
江西省靖安县人民法院	江西
江西省九江市庐山区人民法院	江西
江西省九江市浔阳区人民法院	江西
江西省九江市中级人民法院	江西
江西省九江县人民法院	江西
江西省乐安县人民法院	江西
江西省乐平市人民法院	江西
江西省黎川县人民法院	江西
江西省莲花县人民法院	江西
江西省龙南县人民法院	江西
江西省芦溪县人民法院	江西
江西省庐山人民法院	江西
江西省南昌高新技术产业开发区人民法院	江西
江西省南昌经济技术开发区人民法院	江西
江西省南昌市东湖区人民法院	江西
江西省南昌市青山湖区人民法院	江西
江西省南昌市青云谱区人民法院	江西
江西省南昌市湾里区人民法院	江西
江西省南昌市西湖区人民法院	江西
江西省南昌市新建区人民法院	江西
江西省南昌市中级人民法院	江西
江西省南昌铁路运输法院	江西
江西省南昌铁路运输中级法院	江西
江西省南昌县人民法院	江西
江西省南城县人民法院	江西
江西省南丰县人民法院	江西
江西省宁都县人民法院	江西
江西省彭泽县人民法院	江西
江西省萍乡市安源区人民法院	江西
江西省萍乡市湘东区人民法院	江西
江西省萍乡市中级人民法院	江西
江西省鄱阳县人民法院	江西
江西省铅山县人民法院	江西
江西省全南县人民法院	江西
江西省瑞昌市人民法院	江西
江西省瑞金市人民法院	江西
江西省上高县人民法院	江西
江西省上栗县人民法院	江西
江西省上饶市广丰区人民法院	江西
江西省上饶市信州区人民法院	江西
江西省上饶市中级人民法院	江西
江西省上饶县人民法院	江西
江西省上犹县人民法院	江西
江西省石城县人民法院	江西
江西省遂川县人民法院	江西
江西省泰和县人民法院	江西
江西省铜鼓县人民法院	江西
江西省万安县人民法院	江西
江西省万年县人民法院	江西
江西省万载县人民法院	江西
江西省武宁县人民法院	江西
江西省婺源县人民法院	江西
江西省峡江县人民法院	江西
江西省新干县人民法院	江西
江西省新余市渝水区人民法院	江西
江西省新余市中级人民法院	江西
江西省信丰县人民法院	江西
江西省星子县人民法院	江西
江西省兴国县人民法院	江西
江西省修水县人民法院	江西
江西省寻乌县人民法院	江西
江西省宜春市袁州区人民法院	江西
江西省宜春市中级人民法院	江西
江西省宜丰县人民法院	江西
江西省宜黄县人民法院	江西
江西省弋阳县人民法院	江西
江西省鹰潭市月湖区人民法院	江西
江西省鹰潭市中级人民法院	江西
江西省永丰县人民法院	江西
江西省永新县人民法院	江西
江西省永修县人民法院	江西
江西省于都县人民法院	江西
江西省余干县人民法院	江西
江西省余江县人民法院	江西
江西省玉山县人民法院	江西
江西省樟树市人民法院	江西
江西省资溪县人民法院	江西
辽宁省鞍山市立山区人民法院	辽宁
辽宁省鞍山市千山区人民法院	辽宁
辽宁省鞍山市铁东区人民法院	辽宁
辽宁省鞍山市铁西区人民法院	辽宁
辽宁省鞍山市中级人民法院	辽宁
辽宁省北票市人民法院	辽宁
辽宁省北镇市人民法院	辽宁
辽宁省本溪满族自治县人民法院	辽宁
辽宁省本溪市明山区人民法院	辽宁
辽宁省本溪市南芬区人民法院	辽宁
辽宁省本溪市平山区人民法院	辽宁
辽宁省本溪市溪湖区人民法院	辽宁
辽宁省本溪市中级人民法院	辽宁
辽宁省昌图县人民法院	辽宁
辽宁省朝阳市龙城区人民法院	辽宁
辽宁省朝阳市双塔区人民法院	辽宁
辽宁省朝阳市中级人民法院	辽宁
辽宁省朝阳县人民法院	辽宁
辽宁省大连海事法院	辽宁
辽宁省大连经济技术开发区人民法院	辽宁
辽宁省大连市甘井子区人民法院	辽宁
辽宁省大连市金州区人民法院	辽宁
辽宁省大连市旅顺口区人民法院	辽宁
辽宁省大连市普兰店区人民法院	辽宁
辽宁省大连市沙河口区人民法院	辽宁
辽宁省大连市西岗区人民法院	辽宁
辽宁省大连市中级人民法院	辽宁
辽宁省大连市中山区人民法院	辽宁
辽宁省大连铁路运输法院	辽宁
辽宁省大石桥市人民法院	辽宁
辽宁省大洼县人民法院	辽宁
辽宁省丹东市元宝区人民法院	辽宁
辽宁省丹东市振安区人民法院	辽宁
辽宁省丹东市振兴区人民法院	辽宁
辽宁省丹东市中级人民法院	辽宁
辽宁省丹东铁路运输法院	辽宁
辽宁省灯塔市人民法院	辽宁
辽宁省东港市人民法院	辽宁
辽宁省法库县人民法院	辽宁
辽宁省凤城市人民法院	辽宁
辽宁省抚顺市东洲区人民法院	辽宁
辽宁省抚顺市顺城区人民法院	辽宁
辽宁省抚顺市望花区人民法院	辽宁
辽宁省抚顺市新抚区人民法院	辽宁
辽宁省抚顺市中级人民法院	辽宁
辽宁省抚顺县人民法院	辽宁
辽宁省阜新蒙古族自治县人民法院	辽宁
辽宁省阜新市海州区人民法院	辽宁
辽宁省阜新市清河门区人民法院	辽宁
辽宁省阜新市太平区人民法院	辽宁
辽宁省阜新市细河区人民法院	辽宁
辽宁省阜新市新邱区人民法院	辽宁
辽宁省阜新市中级人民法院	辽宁
辽宁省盖州市人民法院	辽宁
辽宁省高级人民法院	辽宁
辽宁省海城市人民法院	辽宁
辽宁省黑山县人民法院	辽宁
辽宁省葫芦岛市连山区人民法院	辽宁
辽宁省葫芦岛市龙港区人民法院	辽宁
辽宁省葫芦岛市南票区人民法院	辽宁
辽宁省葫芦岛市中级人民法院	辽宁
辽宁省桓仁满族自治县人民法院	辽宁
辽宁省建昌县人民法院	辽宁
辽宁省建平县人民法院	辽宁
辽宁省锦州市滨海新区人民法院	辽宁
辽宁省锦州市古塔区人民法院	辽宁
辽宁省锦州市凌河区人民法院	辽宁
辽宁省锦州市松山新区人民法庭	辽宁
辽宁省锦州市太和区人民法院	辽宁
辽宁省锦州市中级人民法院	辽宁
辽宁省锦州铁路运输法院	辽宁
辽宁省喀喇沁左翼蒙古族自治县人民法院	辽宁
辽宁省开原市人民法院	辽宁
辽宁省康平县人民法院	辽宁
辽宁省宽甸满族自治县人民法院	辽宁
辽宁省辽河人民法院	辽宁
辽宁省辽河中级人民法院	辽宁
辽宁省辽阳市白塔区人民法院	辽宁
辽宁省辽阳市弓长岭区人民法院	辽宁
辽宁省辽阳市宏伟区人民法院	辽宁
辽宁省辽阳市太子河区人民法院	辽宁
辽宁省辽阳市文圣区人民法院	辽宁
辽宁省辽阳市中级人民法院	辽宁
辽宁省辽阳县人民法院	辽宁
辽宁省辽中县人民法院	辽宁
辽宁省凌海市人民法院	辽宁
辽宁省凌源市人民法院	辽宁
辽宁省盘锦市双台子区人民法院	辽宁
辽宁省盘锦市兴隆台区人民法院	辽宁
辽宁省盘锦市中级人民法院	辽宁
辽宁省盘山县人民法院	辽宁
辽宁省普兰店市人民法院	辽宁
辽宁省清原满族自治县人民法院	辽宁
辽宁省沈阳高新技术产业开发区人民法院	辽宁
辽宁省沈阳经济技术开发区人民法院	辽宁
辽宁省沈阳市大东区人民法院	辽宁
辽宁省沈阳市和平区人民法院	辽宁
辽宁省沈阳市皇姑区人民法院	辽宁
辽宁省沈阳市浑南区人民法院	辽宁
辽宁省沈阳市沈北新区人民法院	辽宁
辽宁省沈阳市沈河区人民法院	辽宁
辽宁省沈阳市苏家屯区人民法院	辽宁
辽宁省沈阳市铁西区人民法院	辽宁
辽宁省沈阳市于洪区人民法院	辽宁
辽宁省沈阳市中级人民法院	辽宁
辽宁省沈阳铁路运输法院	辽宁
辽宁省沈阳铁路运输中级法院	辽宁
辽宁省绥中县人民法院	辽宁
辽宁省台安县人民法院	辽宁
辽宁省调兵山市人民法院	辽宁
辽宁省铁岭经济开发区审判庭	辽宁
辽宁省铁岭市清河区人民法院	辽宁
辽宁省铁岭市银州区人民法院	辽宁
辽宁省铁岭市中级人民法院	辽宁
辽宁省铁岭县人民法院	辽宁
辽宁省瓦房店市人民法院	辽宁
辽宁省西丰县人民法院	辽宁
辽宁省新宾满族自治县人民法院	辽宁
辽宁省新民市人民法院	辽宁
辽宁省兴城市人民法院	辽宁
辽宁省岫岩满族自治县人民法院	辽宁
辽宁省义县人民法院	辽宁
辽宁省营口市鲅鱼圈区人民法院	辽宁
辽宁省营口市老边区人民法院	辽宁
辽宁省营口市西市区人民法院	辽宁
辽宁省营口市站前区人民法院	辽宁
辽宁省营口市中级人民法院	辽宁
辽宁省彰武县人民法院	辽宁
辽宁省长海县人民法院	辽宁
辽宁省庄河市人民法院	辽宁
内蒙古自治区阿巴嘎旗人民法院	内蒙古
内蒙古自治区阿尔山市人民法院	内蒙古
内蒙古自治区阿拉善盟中级人民法院	内蒙古
内蒙古自治区阿拉善右旗人民法院	内蒙古
内蒙古自治区阿拉善左旗人民法院	内蒙古
内蒙古自治区阿鲁科尔沁旗人民法院	内蒙古
内蒙古自治区阿荣旗人民法院	内蒙古
内蒙古自治区敖汉旗人民法院	内蒙古
内蒙古自治区巴林右旗人民法院	内蒙古
内蒙古自治区巴林左旗人民法院	内蒙古
内蒙古自治区巴彦淖尔市临河区人民法院	内蒙古
内蒙古自治区巴彦淖尔市中级人民法院	内蒙古
内蒙古自治区包头市白云鄂博矿区人民法院	内蒙古
内蒙古自治区包头市东河区人民法院	内蒙古
内蒙古自治区包头市九原区人民法院	内蒙古
内蒙古自治区包头市昆都仑区人民法院	内蒙古
内蒙古自治区包头市青山区人民法院	内蒙古
内蒙古自治区包头市石拐区人民法院	内蒙古
内蒙古自治区包头市中级人民法院	内蒙古
内蒙古自治区包头铁路运输法院	内蒙古
内蒙古自治区包头稀土高新技术产业开发区人民法院	内蒙古
内蒙古自治区察哈尔右翼后旗人民法院	内蒙古
内蒙古自治区察哈尔右翼前旗人民法院	内蒙古
内蒙古自治区察哈尔右翼中旗人民法院	内蒙古
内蒙古自治区陈巴尔虎旗人民法院	内蒙古
内蒙古自治区赤峰市红山区人民法院	内蒙古
内蒙古自治区赤峰市松山区人民法院	内蒙古
内蒙古自治区赤峰市元宝山区人民法院	内蒙古
内蒙古自治区赤峰市中级人民法院	内蒙古
内蒙古自治区达尔罕茂明安联合旗人民法院	内蒙古
内蒙古自治区达拉特旗人民法院	内蒙古
内蒙古自治区磴口县人民法院	内蒙古
内蒙古自治区东乌珠穆沁旗人民法院	内蒙古
内蒙古自治区多伦县人民法院	内蒙古
内蒙古自治区额尔古纳市人民法院	内蒙古
内蒙古自治区额济纳旗人民法院	内蒙古
内蒙古自治区鄂尔多斯康巴什新区人民法院	内蒙古
内蒙古自治区鄂尔多斯市东胜区人民法院	内蒙古
内蒙古自治区鄂尔多斯市中级人民法院	内蒙古
内蒙古自治区鄂伦春自治旗人民法院	内蒙古
内蒙古自治区鄂托克旗人民法院	内蒙古
内蒙古自治区鄂托克前旗人民法院	内蒙古
内蒙古自治区鄂温克族自治旗人民法院	内蒙古
内蒙古自治区二连浩特市人民法院	内蒙古
内蒙古自治区丰镇市人民法院	内蒙古
内蒙古自治区高级人民法院	内蒙古
内蒙古自治区根河市人民法院	内蒙古
内蒙古自治区固阳县人民法院	内蒙古
内蒙古自治区海拉尔铁路运输法院	内蒙古
内蒙古自治区杭锦后旗人民法院	内蒙古
内蒙古自治区杭锦旗人民法院	内蒙古
内蒙古自治区和林格尔县人民法院	内蒙古
内蒙古自治区呼和浩特市回民区人民法院	内蒙古
内蒙古自治区呼和浩特市赛罕区人民法院	内蒙古
内蒙古自治区呼和浩特市新城区人民法院	内蒙古
内蒙古自治区呼和浩特市玉泉区人民法院	内蒙古
内蒙古自治区呼和浩特市中级人民法院	内蒙古
内蒙古自治区呼和浩特铁路运输法院	内蒙古
内蒙古自治区呼和浩特铁路运输中级法院	内蒙古
内蒙古自治区呼伦贝尔市海拉尔区人民法院	内蒙古
内蒙古自治区呼伦贝尔市中级人民法院	内蒙古
内蒙古自治区化德县人民法院	内蒙古
内蒙古自治区霍林郭勒市人民法院	内蒙古
内蒙古自治区喀喇沁旗人民法院	内蒙古
内蒙古自治区开鲁县人民法院	内蒙古
内蒙古自治区科尔沁右翼前旗人民法院	内蒙古
内蒙古自治区科尔沁右翼中旗人民法院	内蒙古
内蒙古自治区科尔沁左翼后旗人民法院	内蒙古
内蒙古自治区科尔沁左翼中旗人民法院	内蒙古
内蒙古自治区克什克腾旗人民法院	内蒙古
内蒙古自治区库伦旗人民法院	内蒙古
内蒙古自治区凉城县人民法院	内蒙古
内蒙古自治区林西县人民法院	内蒙古
内蒙古自治区满洲里市人民法院	内蒙古
内蒙古自治区莫力达瓦达斡尔族自治旗人民法院	内蒙古
内蒙古自治区奈曼旗人民法院	内蒙古
内蒙古自治区宁城县人民法院	内蒙古
内蒙古自治区清水河县人民法院	内蒙古
内蒙古自治区商都县人民法院	内蒙古
内蒙古自治区四子王旗人民法院	内蒙古
内蒙古自治区苏尼特右旗人民法院	内蒙古
内蒙古自治区苏尼特左旗人民法院	内蒙古
内蒙古自治区太仆寺旗人民法院	内蒙古
内蒙古自治区通辽市科尔沁区人民法院	内蒙古
内蒙古自治区通辽市中级人民法院	内蒙古
内蒙古自治区通辽铁路运输法院	内蒙古
内蒙古自治区突泉县人民法院	内蒙古
内蒙古自治区土默特右旗人民法院	内蒙古
内蒙古自治区土默特左旗人民法院	内蒙古
内蒙古自治区托克托县人民法院	内蒙古
内蒙古自治区翁牛特旗人民法院	内蒙古
内蒙古自治区乌海市海勃湾区人民法院	内蒙古
内蒙古自治区乌海市海南区人民法院	内蒙古
内蒙古自治区乌海市乌达区人民法院	内蒙古
内蒙古自治区乌海市中级人民法院	内蒙古
内蒙古自治区乌拉特后旗人民法院	内蒙古
内蒙古自治区乌拉特前旗人民法院	内蒙古
内蒙古自治区乌拉特中旗人民法院	内蒙古
内蒙古自治区乌兰察布市集宁区人民法院	内蒙古
内蒙古自治区乌兰察布市中级人民法院	内蒙古
内蒙古自治区乌兰浩特市人民法院	内蒙古
内蒙古自治区乌审旗人民法院	内蒙古
内蒙古自治区五原县人民法院	内蒙古
内蒙古自治区武川县人民法院	内蒙古
内蒙古自治区西乌珠穆沁旗人民法院	内蒙古
内蒙古自治区锡林郭勒盟中级人民法院	内蒙古
内蒙古自治区锡林浩特市人民法院	内蒙古
内蒙古自治区镶黄旗人民法院	内蒙古
内蒙古自治区新巴尔虎右旗人民法院	内蒙古
内蒙古自治区新巴尔虎左旗人民法院	内蒙古
内蒙古自治区兴安盟中级人民法院	内蒙古
内蒙古自治区兴和县人民法院	内蒙古
内蒙古自治区牙克石市人民法院	内蒙古
内蒙古自治区伊金霍洛旗人民法院	内蒙古
内蒙古自治区扎赉特旗人民法院	内蒙古
内蒙古自治区扎兰屯市人民法院	内蒙古
内蒙古自治区扎鲁特旗人民法院	内蒙古
内蒙古自治区正蓝旗人民法院	内蒙古
内蒙古自治区正镶白旗人民法院	内蒙古
内蒙古自治区准格尔旗人民法院	内蒙古
内蒙古自治区卓资县人民法院	内蒙古
宁夏回族自治区高级人民法院	宁夏
宁夏回族自治区固原市原州区人民法院	宁夏
宁夏回族自治区固原市中级人民法院	宁夏
宁夏回族自治区海原县人民法院	宁夏
宁夏回族自治区贺兰县人民法院	宁夏
宁夏回族自治区泾源县人民法院	宁夏
宁夏回族自治区灵武市人民法院	宁夏
宁夏回族自治区隆德县人民法院	宁夏
宁夏回族自治区彭阳县人民法院	宁夏
宁夏回族自治区平罗县人民法院	宁夏
宁夏回族自治区青铜峡市人民法院	宁夏
宁夏回族自治区石嘴山市大武口区人民法院	宁夏
宁夏回族自治区石嘴山市惠农区人民法院	宁夏
宁夏回族自治区石嘴山市中级人民法院	宁夏
宁夏回族自治区同心县人民法院	宁夏
宁夏回族自治区吴忠市红寺堡开发区人民法院	宁夏
宁夏回族自治区吴忠市利通区人民法院	宁夏
宁夏回族自治区吴忠市中级人民法院	宁夏
宁夏回族自治区西吉县人民法院	宁夏
宁夏回族自治区盐池县人民法院	宁夏
宁夏回族自治区银川市金凤区人民法院	宁夏
宁夏回族自治区银川市西夏区人民法院	宁夏
宁夏回族自治区银川市兴庆区人民法院	宁夏
宁夏回族自治区银川市中级人民法院	宁夏
宁夏回族自治区银川铁路运输法院	宁夏
宁夏回族自治区永宁县人民法院	宁夏
宁夏回族自治区中宁县人民法院	宁夏
宁夏回族自治区中卫市沙坡头区人民法院	宁夏
宁夏回族自治区中卫市中级人民法院	宁夏
青海省班玛县人民法院	青海
青海省称多县人民法院	青海
青海省达日县人民法院	青海
青海省大柴旦矿区人民法院	青海
青海省大通回族土族自治县人民法院	青海
青海省德令哈市人民法院	青海
青海省都兰县人民法院	青海
青海省甘德县人民法院	青海
青海省刚察县人民法院	青海
青海省高级人民法院	青海
青海省格尔木市人民法院	青海
青海省共和县人民法院	青海
青海省贵德县人民法院	青海
青海省贵南县人民法院	青海
青海省果洛藏族自治州中级人民法院	青海
青海省海北藏族自治州中级人民法院	青海
青海省海东市乐都区人民法院	青海
青海省海东市平安区人民法院	青海
青海省海东市中级人民法院	青海
青海省海南藏族自治州中级人民法院	青海
青海省海西蒙古族藏族自治州中级人民法院	青海
青海省海晏县人民法院	青海
青海省河南蒙古族自治县人民法院	青海
青海省互助土族自治县人民法院	青海
青海省化隆回族自治县人民法院	青海
青海省黄南藏族自治州中级人民法院	青海
青海省湟源县人民法院	青海
青海省湟中县人民法院	青海
青海省尖扎县人民法院	青海
青海省久治县人民法院	青海
青海省冷湖矿区人民法院	青海
青海省玛多县人民法院	青海
青海省玛沁县人民法院	青海
青海省茫崖矿区人民法院	青海
青海省门源回族自治县人民法院	青海
青海省民和回族土族自治县人民法院	青海
青海省囊谦县人民法院	青海
青海省祁连县人民法院	青海
青海省曲麻莱县人民法院	青海
青海省天峻县人民法院	青海
青海省同德县人民法院	青海
青海省同仁县人民法院	青海
青海省乌兰县人民法院	青海
青海省西宁市城北区人民法院	青海
青海省西宁市城东区人民法院	青海
青海省西宁市城西区人民法院	青海
青海省西宁市城中区人民法院	青海
青海省西宁市中级人民法院	青海
青海省西宁铁路运输法院	青海
青海省兴海县人民法院	青海
青海省循化撒拉族自治县人民法院	青海
青海省玉树藏族自治州中级人民法院	青海
青海省玉树市人民法院	青海
青海省杂多县人民法院	青海
青海省泽库县人民法院	青海
青海省治多县人民法院	青海
山东省安丘市人民法院	山东
山东省滨州经济技术开发区人民法院	山东
山东省滨州市滨城区人民法院	山东
山东省滨州市沾化区人民法院	山东
山东省滨州市中级人民法院	山东
山东省博兴县人民法院	山东
山东省曹县人民法院	山东
山东省昌乐县人民法院	山东
山东省昌邑市人民法院	山东
山东省成武县人民法院	山东
山东省茌平县人民法院	山东
山东省单县人民法院	山东
山东省德州经济开发区人民法院	山东
山东省德州市德城区人民法院	山东
山东省德州市陵城区人民法院	山东
山东省德州市中级人民法院	山东
山东省定陶县人民法院	山东
山东省东阿县人民法院	山东
山东省东明县人民法院	山东
山东省东平县人民法院	山东
山东省东营经济技术开发区人民法院	山东
山东省东营市东营区人民法院	山东
山东省东营市河口区人民法院	山东
山东省东营市中级人民法院	山东
山东省肥城市人民法院	山东
山东省费县人民法院	山东
山东省高级人民法院	山东
山东省高密市人民法院	山东
山东省高青县人民法院	山东
山东省高唐县人民法院	山东
山东省冠县人民法院	山东
山东省广饶县人民法院	山东
山东省海阳市人民法院	山东
山东省菏泽经济开发区人民法院	山东
山东省菏泽市牡丹区人民法院	山东
山东省菏泽市中级人民法院	山东
山东省桓台县人民法院	山东
山东省惠民县人民法院	山东
山东省即墨市人民法院	山东
山东省济南高新技术产业开发区人民法院	山东
山东省济南市槐荫区人民法院	山东
山东省济南市历城区人民法院	山东
山东省济南市历下区人民法院	山东
山东省济南市市中区人民法院	山东
山东省济南市天桥区人民法院	山东
山东省济南市长清区人民法院	山东
山东省济南市中级人民法院	山东
山东省济南铁路运输法院	山东
山东省济南铁路运输中级法院	山东
山东省济宁高新技术产业开发区人民法院	山东
山东省济宁市任城区人民法院	山东
山东省济宁市兖州区人民法院	山东
山东省济宁市中级人民法院	山东
山东省济阳县人民法院	山东
山东省嘉祥县人民法院	山东
山东省胶州市人民法院	山东
山东省金乡县人民法院	山东
山东省莒南县人民法院	山东
山东省莒县人民法院	山东
山东省巨野县人民法院	山东
山东省鄄城县人民法院	山东
山东省垦利县人民法院	山东
山东省莱芜市钢城区人民法院	山东
山东省莱芜市莱城区人民法院	山东
山东省莱芜市中级人民法院	山东
山东省莱西市人民法院	山东
山东省莱阳市人民法院	山东
山东省莱州市人民法院	山东
山东省兰陵县人民法院	山东
山东省乐陵市人民法院	山东
山东省利津县人民法院	山东
山东省梁山县人民法院	山东
山东省聊城经济技术开发区人民法院	山东
山东省聊城市东昌府区人民法院	山东
山东省聊城市中级人民法院	山东
山东省临清市人民法院	山东
山东省临朐县人民法院	山东
山东省临沭县人民法院	山东
山东省临沂高新技术产业开发区人民法院	山东
山东省临沂经济技术开发区人民法院	山东
山东省临沂市河东区人民法院	山东
山东省临沂市兰山区人民法院	山东
山东省临沂市罗庄区人民法院	山东
山东省临沂市中级人民法院	山东
山东省临邑县人民法院	山东
山东省龙口市人民法院	山东
山东省蒙阴县人民法院	山东
山东省宁津县人民法院	山东
山东省宁阳县人民法院	山东
山东省蓬莱市人民法院	山东
山东省平度市人民法院	山东
山东省平邑县人民法院	山东
山东省平阴县人民法院	山东
山东省平原县人民法院	山东
山东省栖霞市人民法院	山东
山东省齐河县人民法院	山东
山东省青岛海事法院	山东
山东省青岛市城阳区人民法院	山东
山东省青岛市黄岛区人民法院	山东
山东省青岛市崂山区人民法院	山东
山东省青岛市李沧区人民法院	山东
山东省青岛市市北区人民法院	山东
山东省青岛市市南区人民法院	山东
山东省青岛市中级人民法院	山东
山东省青岛铁路运输法院	山东
山东省青州市人民法院	山东
山东省庆云县人民法院	山东
山东省曲阜市人民法院	山东
山东省日照经济技术开发区人民法院	山东
山东省日照市东港区人民法院	山东
山东省日照市岚山区人民法院	山东
山东省日照市中级人民法院	山东
山东省荣成市人民法院	山东
山东省乳山市人民法院	山东
山东省商河县人民法院	山东
山东省莘县人民法院	山东
山东省寿光市人民法院	山东
山东省泗水县人民法院	山东
山东省泰安高新技术产业开发区人民法院	山东
山东省泰安市岱岳区人民法院	山东
山东省泰安市泰山区人民法院	山东
山东省泰安市中级人民法院	山东
山东省郯城县人民法院	山东
山东省滕州市人民法院	山东
山东省威海火炬高技术产业开发区人民法院	山东
山东省威海经济技术开发区人民法院	山东
山东省威海市环翠区人民法院	山东
山东省威海市文登区人民法院	山东
山东省威海市中级人民法院	山东
山东省微山县人民法院	山东
山东省潍坊滨海经济技术开发区人民法院	山东
山东省潍坊高新技术产业开发区人民法院	山东
山东省潍坊市坊子区人民法院	山东
山东省潍坊市寒亭区人民法院	山东
山东省潍坊市奎文区人民法院	山东
山东省潍坊市潍城区人民法院	山东
山东省潍坊市中级人民法院	山东
山东省汶上县人民法院	山东
山东省无棣县人民法院	山东
山东省五莲县人民法院	山东
山东省武城县人民法院	山东
山东省夏津县人民法院	山东
山东省新泰市人民法院	山东
山东省烟台高新技术产业开发区人民法院	山东
山东省烟台经济技术开发区人民法院	山东
山东省烟台市福山区人民法院	山东
山东省烟台市莱山区人民法院	山东
山东省烟台市牟平区人民法院	山东
山东省烟台市芝罘区人民法院	山东
山东省烟台市中级人民法院	山东
山东省阳谷县人民法院	山东
山东省阳信县人民法院	山东
山东省沂南县人民法院	山东
山东省沂水县人民法院	山东
山东省沂源县人民法院	山东
山东省鱼台县人民法院	山东
山东省禹城市人民法院	山东
山东省郓城县人民法院	山东
山东省枣庄市山亭区人民法院	山东
山东省枣庄市市中区人民法院	山东
山东省枣庄市台儿庄区人民法院	山东
山东省枣庄市薛城区人民法院	山东
山东省枣庄市峄城区人民法院	山东
山东省枣庄市中级人民法院	山东
山东省章丘市人民法院	山东
山东省长岛县人民法院	山东
山东省招远市人民法院	山东
山东省诸城市人民法院	山东
山东省淄博高新技术产业开发区人民法院	山东
山东省淄博市博山区人民法院	山东
山东省淄博市临淄区人民法院	山东
山东省淄博市张店区人民法院	山东
山东省淄博市中级人民法院	山东
山东省淄博市周村区人民法院	山东
山东省淄博市淄川区人民法院	山东
山东省邹城市人民法院	山东
山东省邹平县人民法院	山东
山西省安泽县人民法院	山西
山西省保德县人民法院	山西
山西省大宁县人民法院	山西
山西省大同市城区人民法院	山西
山西省大同市矿区人民法院	山西
山西省大同市南郊区人民法院	山西
山西省大同市新荣区人民法院	山西
山西省大同市中级人民法院	山西
山西省大同铁路运输法院	山西
山西省大同县人民法院	山西
山西省代县人民法院	山西
山西省定襄县人民法院	山西
山西省繁峙县人民法院	山西
山西省方山县人民法院	山西
山西省汾西县人民法院	山西
山西省汾阳市人民法院	山西
山西省浮山县人民法院	山西
山西省高级人民法院	山西
山西省高平市人民法院	山西
山西省古交市人民法院	山西
山西省古县人民法院	山西
山西省广灵县人民法院	山西
山西省和顺县人民法院	山西
山西省河津市人民法院	山西
山西省河曲县人民法院	山西
山西省洪洞县人民法院	山西
山西省侯马市人民法院	山西
山西省壶关县人民法院	山西
山西省怀仁县人民法院	山西
山西省浑源县人民法院	山西
山西省霍州市人民法院	山西
山西省吉县人民法院	山西
山西省稷山县人民法院	山西
山西省绛县人民法院	山西
山西省交城县人民法院	山西
山西省交口县人民法院	山西
山西省介休市人民法院	山西
山西省晋城市城区人民法院	山西
山西省晋城市中级人民法院	山西
山西省晋中市榆次区人民法院	山西
山西省晋中市中级人民法院	山西
山西省静乐县人民法院	山西
山西省岢岚县人民法院	山西
山西省岚县人民法院	山西
山西省黎城县人民法院	山西
山西省临汾市尧都区人民法院	山西
山西省临汾市中级人民法院	山西
山西省临汾铁路运输法院	山西
山西省临县人民法院	山西
山西省临猗县人民法院	山西
山西省灵丘县人民法院	山西
山西省灵石县人民法院	山西
山西省陵川县人民法院	山西
山西省柳林县人民法院	山西
山西省娄烦县人民法院	山西
山西省潞城市人民法院	山西
山西省吕梁市离石区人民法院	山西
山西省吕梁市中级人民法院	山西
山西省宁武县人民法院	山西
山西省偏关县人民法院	山西
山西省平定县人民法院	山西
山西省平陆县人民法院	山西
山西省平顺县人民法院	山西
山西省平遥县人民法院	山西
山西省蒲县人民法院	山西
山西省祁县人民法院	山西
山西省沁水县人民法院	山西
山西省沁县人民法院	山西
山西省沁源县人民法院	山西
山西省清徐县人民法院	山西
山西省曲沃县人民法院	山西
山西省芮城县人民法院	山西
山西省山阴县人民法院	山西
山西省神池县人民法院	山西
山西省石楼县人民法院	山西
山西省寿阳县人民法院	山西
山西省朔州市平鲁区人民法院	山西
山西省朔州市朔城区人民法院	山西
山西省朔州市中级人民法院	山西
山西省太谷县人民法院	山西
山西省太原市尖草坪区人民法院	山西
山西省太原市晋源区人民法院	山西
山西省太原市万柏林区人民法院	山西
山西省太原市小店区人民法院	山西
山西省太原市杏花岭区人民法院	山西
山西省太原市迎泽区人民法院	山西
山西省太原市中级人民法院	山西
山西省太原铁路运输法院	山西
山西省太原铁路运输中级法院	山西
山西省天镇县人民法院	山西
山西省屯留县人民法院	山西
山西省万荣县人民法院	山西
山西省文水县人民法院	山西
山西省闻喜县人民法院	山西
山西省五台县人民法院	山西
山西省五寨县人民法院	山西
山西省武乡县人民法院	山西
山西省昔阳县人民法院	山西
山西省隰县人民法院	山西
山西省夏县人民法院	山西
山西省乡宁县人民法院	山西
山西省襄汾县人民法院	山西
山西省襄垣县人民法院	山西
山西省孝义市人民法院	山西
山西省忻州市忻府区人民法院	山西
山西省忻州市中级人民法院	山西
山西省新绛县人民法院	山西
山西省兴县人民法院	山西
山西省阳城县人民法院	山西
山西省阳高县人民法院	山西
山西省阳曲县人民法院	山西
山西省阳泉市城区人民法院	山西
山西省阳泉市郊区人民法院	山西
山西省阳泉市矿区人民法院	山西
山西省阳泉市中级人民法院	山西
山西省翼城县人民法院	山西
山西省应县人民法院	山西
山西省永和县人民法院	山西
山西省永济市人民法院	山西
山西省右玉县人民法院	山西
山西省盂县人民法院	山西
山西省榆社县人民法院	山西
山西省垣曲县人民法院	山西
山西省原平市人民法院	山西
山西省运城市盐湖区人民法院	山西
山西省运城市中级人民法院	山西
山西省泽州县人民法院	山西
山西省长治市城区人民法院	山西
山西省长治市郊区人民法院	山西
山西省长治市中级人民法院	山西
山西省长治县人民法院	山西
山西省长子县人民法院	山西
山西省中阳县人民法院	山西
山西省左权县人民法院	山西
山西省左云县人民法院	山西
陕西省安康市汉滨区人民法院	陕西
陕西省安康市中级人民法院	陕西
陕西省安康铁路运输法院	陕西
陕西省安塞县人民法院	陕西
陕西省白河县人民法院	陕西
陕西省白水县人民法院	陕西
陕西省宝鸡市陈仓区人民法院	陕西
陕西省宝鸡市金台区人民法院	陕西
陕西省宝鸡市渭滨区人民法院	陕西
陕西省宝鸡市中级人民法院	陕西
陕西省彬县人民法院	陕西
陕西省城固县人民法院	陕西
陕西省澄城县人民法院	陕西
陕西省淳化县人民法院	陕西
陕西省大荔县人民法院	陕西
陕西省丹凤县人民法院	陕西
陕西省定边县人民法院	陕西
陕西省凤县人民法院	陕西
陕西省凤翔县人民法院	陕西
陕西省佛坪县人民法院	陕西
陕西省扶风县人民法院	陕西
陕西省府谷县人民法院	陕西
陕西省富平县人民法院	陕西
陕西省富县人民法院	陕西
陕西省甘泉县人民法院	陕西
陕西省高级人民法院	陕西
陕西省高陵县人民法院	陕西
陕西省韩城市人民法院	陕西
陕西省汉阴县人民法院	陕西
陕西省汉中市汉台区人民法院	陕西
陕西省汉中市中级人民法院	陕西
陕西省合阳县人民法院	陕西
陕西省横山县人民法院	陕西
陕西省户县人民法院	陕西
陕西省华县人民法院	陕西
陕西省华阴市人民法院	陕西
陕西省黄陵县人民法院	陕西
陕西省黄龙县人民法院	陕西
陕西省佳县人民法院	陕西
陕西省泾阳县人民法院	陕西
陕西省靖边县人民法院	陕西
陕西省岚皋县人民法院	陕西
陕西省蓝田县人民法院	陕西
陕西省礼泉县人民法院	陕西
陕西省麟游县人民法院	陕西
陕西省留坝县人民法院	陕西
陕西省陇县人民法院	陕西
陕西省洛川县人民法院	陕西
陕西省洛南县人民法院	陕西
陕西省略阳县人民法院	陕西
陕西省眉县人民法院	陕西
陕西省米脂县人民法院	陕西
陕西省勉县人民法院	陕西
陕西省南郑县人民法院	陕西
陕西省宁强县人民法院	陕西
陕西省宁陕县人民法院	陕西
陕西省平利县人民法院	陕西
陕西省蒲城县人民法院	陕西
陕西省岐山县人民法院	陕西
陕西省歧山县人民法院	陕西
陕西省千阳县人民法院	陕西
陕西省乾县人民法院	陕西
陕西省清涧县人民法院	陕西
陕西省三原县人民法院	陕西
陕西省山阳县人民法院	陕西
陕西省商洛市商州区人民法院	陕西
陕西省商洛市中级人民法院	陕西
陕西省商南县人民法院	陕西
陕西省神木县人民法院	陕西
陕西省石泉县人民法院	陕西
陕西省绥德县人民法院	陕西
陕西省太白县人民法院	陕西
陕西省铜川市王益区人民法院	陕西
陕西省铜川市耀州区人民法院	陕西
陕西省铜川市印台区人民法院	陕西
陕西省铜川市中级人民法院	陕西
陕西省潼关县人民法院	陕西
陕西省渭南市华州区人民法院	陕西
陕西省渭南市临渭区人民法院	陕西
陕西省渭南市中级人民法院	陕西
陕西省吴堡县人民法院	陕西
陕西省吴起县人民法院	陕西
陕西省武功县人民法院	陕西
陕西省西安市灞桥区人民法院	陕西
陕西省西安市碑林区人民法院	陕西
陕西省西安市高陵区人民法院	陕西
陕西省西安市莲湖区人民法院	陕西
陕西省西安市临潼区人民法院	陕西
陕西省西安市未央区人民法院	陕西
陕西省西安市新城区人民法院	陕西
陕西省西安市阎良区人民法院	陕西
陕西省西安市雁塔区人民法院	陕西
陕西省西安市长安区人民法院	陕西
陕西省西安市中级人民法院	陕西
陕西省西安铁路运输法院	陕西
陕西省西安铁路运输中级法院	陕西
陕西省西乡县人民法院	陕西
陕西省咸阳市秦都区人民法院	陕西
陕西省咸阳市渭城区人民法院	陕西
陕西省咸阳市杨陵区人民法院	陕西
陕西省咸阳市中级人民法院	陕西
陕西省兴平市人民法院	陕西
陕西省旬阳县人民法院	陕西
陕西省旬邑县人民法院	陕西
陕西省延安市宝塔区人民法院	陕西
陕西省延安市中级人民法院	陕西
陕西省延川县人民法院	陕西
陕西省延长县人民法院	陕西
陕西省洋县人民法院	陕西
陕西省宜川县人民法院	陕西
陕西省宜君县人民法院	陕西
陕西省永寿县人民法院	陕西
陕西省榆林市榆阳区人民法院	陕西
陕西省榆林市中级人民法院	陕西
陕西省柞水县人民法院	陕西
陕西省长武县人民法院	陕西
陕西省镇安县人民法院	陕西
陕西省镇巴县人民法院	陕西
陕西省镇坪县人民法院	陕西
陕西省志丹县人民法院	陕西
陕西省周至县人民法院	陕西
陕西省子长县人民法院	陕西
陕西省子洲县人民法院	陕西
陕西省紫阳县人民法院	陕西
上海海事法院	上海
上海市宝山区人民法院	上海
上海市崇明县人民法院	上海
上海市第二中级人民法院	上海
上海市第三中级人民法院	上海
上海市第一中级人民法院	上海
上海市奉贤区人民法院	上海
上海市高级人民法院	上海
上海市虹口区人民法院	上海
上海市黄浦区人民法院	上海
上海市嘉定区人民法院	上海
上海市金山区人民法院	上海
上海市静安区人民法院	上海
上海市闵行区人民法院	上海
上海市浦东新区人民法院	上海
上海市普陀区人民法院	上海
上海市青浦区人民法院	上海
上海市松江区人民法院	上海
上海市徐汇区人民法院	上海
上海市杨浦区人民法院	上海
上海市闸北区人民法院	上海
上海市长宁区人民法院	上海
上海铁路运输法院	上海
上海铁路运输中级法院	上海
上海知识产权法院	上海
四川省阿坝藏族羌族自治州中级人民法院	四川
四川省阿坝县人民法院	四川
四川省安县人民法院	四川
四川省安岳县人民法院	四川
四川省巴塘县人民法院	四川
四川省巴中市巴州区人民法院	四川
四川省巴中市恩阳区人民法院	四川
四川省巴中市中级人民法院	四川
四川省白玉县人民法院	四川
四川省宝兴县人民法院	四川
四川省北川羌族自治县人民法院	四川
四川省布拖县人民法院	四川
四川省苍溪县人民法院	四川
四川省成都高新技术产业开发区人民法院	四川
四川省成都市成华区人民法院	四川
四川省成都市金牛区人民法院	四川
四川省成都市锦江区人民法院	四川
四川省成都市龙泉驿区人民法院	四川
四川省成都市青白江区人民法院	四川
四川省成都市青羊区人民法院	四川
四川省成都市温江区人民法院	四川
四川省成都市武侯区人民法院	四川
四川省成都市新都区人民法院	四川
四川省成都市中级人民法院	四川
四川省成都铁路运输法院	四川
四川省成都铁路运输中级法院	四川
四川省崇州市人民法院	四川
四川省达州市达川区人民法院	四川
四川省达州市通川区人民法院	四川
四川省达州市中级人民法院	四川
四川省大邑县人民法院	四川
四川省大英县人民法院	四川
四川省大竹县人民法院	四川
四川省丹巴县人民法院	四川
四川省丹棱县人民法院	四川
四川省道孚县人民法院	四川
四川省稻城县人民法院	四川
四川省得荣县人民法院	四川
四川省德昌县人民法院	四川
四川省德格县人民法院	四川
四川省德阳市旌阳区人民法院	四川
四川省德阳市中级人民法院	四川
四川省都江堰市人民法院	四川
四川省峨边彝族自治县人民法院	四川
四川省峨眉山市人民法院	四川
四川省富顺县人民法院	四川
四川省甘洛县人民法院	四川
四川省甘孜藏族自治州中级人民法院	四川
四川省甘孜县人民法院	四川
四川省高级人民法院	四川
四川省高县人民法院	四川
四川省珙县人民法院	四川
四川省古蔺县人民法院	四川
四川省广安市广安区人民法院	四川
四川省广安市前锋区人民法院	四川
四川省广安市中级人民法院	四川
四川省广汉市人民法院	四川
四川省广元市朝天区人民法院	四川
四川省广元市利州区人民法院	四川
四川省广元市昭化区人民法院	四川
四川省广元市中级人民法院	四川
四川省汉源县人民法院	四川
四川省合江县人民法院	四川
四川省黑水县人民法院	四川
四川省红原县人民法院	四川
四川省洪雅县人民法院	四川
四川省华蓥市人民法院	四川
四川省会东县人民法院	四川
四川省会理县人民法院	四川
四川省夹江县人民法院	四川
四川省犍为县人民法院	四川
四川省简阳市人民法院	四川
四川省剑阁县人民法院	四川
四川省江安县人民法院	四川
四川省江油市人民法院	四川
四川省金川县人民法院	四川
四川省金堂县人民法院	四川
四川省金阳县人民法院	四川
四川省井研县人民法院	四川
四川省九龙县人民法院	四川
四川省九寨沟县人民法院	四川
四川省筠连县人民法院	四川
四川省开江县人民法院	四川
四川省康定市人民法院	四川
四川省康定县人民法院	四川
四川省阆中市人民法院	四川
四川省乐山市金口河区人民法院	四川
四川省乐山市沙湾区人民法院	四川
四川省乐山市市中区人民法院	四川
四川省乐山市五通桥区人民法院	四川
四川省乐山市中级人民法院	四川
四川省乐至县人民法院	四川
四川省雷波县人民法院	四川
四川省理塘县人民法院	四川
四川省理县人民法院	四川
四川省凉山彝族自治州中级人民法院	四川
四川省邻水县人民法院	四川
四川省隆昌县人民法院	四川
四川省芦山县人民法院	四川
四川省炉霍县人民法院	四川
四川省泸定县人民法院	四川
四川省泸县人民法院	四川
四川省泸州市江阳区人民法院	四川
四川省泸州市龙马潭区人民法院	四川
四川省泸州市纳溪区人民法院	四川
四川省泸州市中级人民法院	四川
四川省罗江县人民法院	四川
四川省马边彝族自治县人民法院	四川
四川省马尔康市人民法院	四川
四川省马尔康县人民法院	四川
四川省茂县人民法院	四川
四川省眉山市东坡区人民法院	四川
四川省眉山市彭山区人民法院	四川
四川省眉山市中级人民法院	四川
四川省美姑县人民法院	四川
四川省米易县人民法院	四川
四川省绵阳高新技术产业开发区人民法院	四川
四川省绵阳市涪城区人民法院	四川
四川省绵阳市游仙区人民法院	四川
四川省绵阳市中级人民法院	四川
四川省绵竹市人民法院	四川
四川省冕宁县人民法院	四川
四川省木里藏族自治县人民法院	四川
四川省沐川县人民法院	四川
四川省南部县人民法院	四川
四川省南充市高坪区人民法院	四川
四川省南充市嘉陵区人民法院	四川
四川省南充市顺庆区人民法院	四川
四川省南充市中级人民法院	四川
四川省南江县人民法院	四川
四川省内江市东兴区人民法院	四川
四川省内江市市中区人民法院	四川
四川省内江市中级人民法院	四川
四川省宁南县人民法院	四川
四川省攀枝花市东区人民法院	四川
四川省攀枝花市仁和区人民法院	四川
四川省攀枝花市西区人民法院	四川
四川省攀枝花市中级人民法院	四川
四川省彭山县人民法院	四川
四川省彭州市人民法院	四川
四川省蓬安县人民法院	四川
四川省蓬溪县人民法院	四川
四川省郫县人民法院	四川
四川省平昌县人民法院	四川
四川省平武县人民法院	四川
四川省屏山县人民法院	四川
四川省蒲江县人民法院	四川
四川省普格县人民法院	四川
四川省青川县人民法院	四川
四川省青神县人民法院	四川
四川省邛崃市人民法院	四川
四川省渠县人民法院	四川
四川省壤塘县人民法院	四川
四川省仁寿县人民法院	四川
四川省荣县人民法院	四川
四川省若尔盖县人民法院	四川
四川省三台县人民法院	四川
四川省色达县人民法院	四川
四川省射洪县人民法院	四川
四川省什邡市人民法院	四川
四川省石棉县人民法院	四川
四川省石渠县人民法院	四川
四川省双流县人民法院	四川
四川省四川省科学城人民法院	四川
四川省松潘县人民法院	四川
四川省遂宁市安居区人民法院	四川
四川省遂宁市船山区人民法院	四川
四川省遂宁市中级人民法院	四川
四川省天全县人民法院	四川
四川省通江县人民法院	四川
四川省万源市人民法院	四川
四川省旺苍县人民法院	四川
四川省威远县人民法院	四川
四川省汶川县人民法院	四川
四川省武胜县人民法院	四川
四川省西昌市人民法院	四川
四川省西昌铁路运输法院	四川
四川省西充县人民法院	四川
四川省喜德县人民法院	四川
四川省乡城县人民法院	四川
四川省小金县人民法院	四川
四川省新津县人民法院	四川
四川省新龙县人民法院	四川
四川省兴文县人民法院	四川
四川省叙永县人民法院	四川
四川省宣汉县人民法院	四川
四川省雅安市名山区人民法院	四川
四川省雅安市雨城区人民法院	四川
四川省雅安市中级人民法院	四川
四川省雅江县人民法院	四川
四川省盐边县人民法院	四川
四川省盐亭县人民法院	四川
四川省盐源县人民法院	四川
四川省仪陇县人民法院	四川
四川省宜宾市翠屏区人民法院	四川
四川省宜宾市南溪区人民法院	四川
四川省宜宾市中级人民法院	四川
四川省宜宾县人民法院	四川
四川省荥经县人民法院	四川
四川省营山县人民法院	四川
四川省岳池县人民法院	四川
四川省越西县人民法院	四川
四川省长宁县人民法院	四川
四川省昭觉县人民法院	四川
四川省中江县人民法院	四川
四川省资阳市雁江区人民法院	四川
四川省资阳市中级人民法院	四川
四川省资中县人民法院	四川
四川省梓潼县人民法院	四川
四川省自贡市大安区人民法院	四川
四川省自贡市贡井区人民法院	四川
四川省自贡市沿滩区人民法院	四川
四川省自贡市中级人民法院	四川
四川省自贡市自流井区人民法院	四川
天津市蓟县人民法院	天津
天津海事法院	天津
天津市宝坻区人民法院	天津
天津市北辰区人民法院	天津
天津市滨海新区人民法院	天津
天津市第二中级人民法院	天津
天津市第一中级人民法院	天津
天津市东丽区人民法院	天津
天津市高级人民法院	天津
天津市和平区人民法院	天津
天津市河北区人民法院	天津
天津市河东区人民法院	天津
天津市河西区人民法院	天津
天津市红桥区人民法院	天津
天津市津南区人民法院	天津
天津市静海区人民法院	天津
天津市南开区人民法院	天津
天津市宁河区人民法院	天津
天津市武清区人民法院	天津
天津市西青区人民法院	天津
天津铁路运输法院	天津
西藏自治区阿里地区中级人民法院	西藏
西藏自治区安多县人民法院	西藏
西藏自治区昂仁县人民法院	西藏
西藏自治区八宿县人民法院	西藏
西藏自治区巴青县人民法院	西藏
西藏自治区白朗县人民法院	西藏
西藏自治区班戈县人民法院	西藏
西藏自治区比如县人民法院	西藏
西藏自治区边坝县人民法院	西藏
西藏自治区波密县人民法院	西藏
西藏自治区察雅县人民法院	西藏
西藏自治区察隅县人民法院	西藏
西藏自治区昌都市卡若区人民法院	西藏
西藏自治区昌都市中级人民法院	西藏
西藏自治区措美县人民法院	西藏
西藏自治区措勤县人民法院	西藏
西藏自治区错那县人民法院	西藏
西藏自治区达孜县人民法院	西藏
西藏自治区当雄县人民法院	西藏
西藏自治区丁青县人民法院	西藏
西藏自治区定结县人民法院	西藏
西藏自治区定日县人民法院	西藏
西藏自治区堆龙德庆县人民法院	西藏
西藏自治区噶尔县人民法院	西藏
西藏自治区改则县人民法院	西藏
西藏自治区岗巴县人民法院	西藏
西藏自治区高级人民法院	西藏
西藏自治区革吉县人民法院	西藏
西藏自治区工布江达县人民法院	西藏
西藏自治区贡嘎县人民法院	西藏
西藏自治区贡觉县人民法院	西藏
西藏自治区吉隆县人民法院	西藏
西藏自治区加查县人民法院	西藏
西藏自治区嘉黎县人民法院	西藏
西藏自治区江达县人民法院	西藏
西藏自治区江孜县人民法院	西藏
西藏自治区康马县人民法院	西藏
西藏自治区拉萨市城关区人民法院	西藏
西藏自治区拉萨市中级人民法院	西藏
西藏自治区拉孜县人民法院	西藏
西藏自治区朗县人民法院	西藏
西藏自治区浪卡子县人民法院	西藏
西藏自治区类乌齐县人民法院	西藏
西藏自治区林芝市巴宜区人民法院	西藏
西藏自治区林芝市中级人民法院	西藏
西藏自治区林周县人民法院	西藏
西藏自治区隆子县人民法院	西藏
西藏自治区洛隆县人民法院	西藏
西藏自治区洛扎县人民法院	西藏
西藏自治区芒康县人民法院	西藏
西藏自治区米林县人民法院	西藏
西藏自治区墨脱县人民法院	西藏
西藏自治区墨竹工卡县人民法院	西藏
西藏自治区那曲地区中级人民法院	西藏
西藏自治区那曲县人民法院	西藏
西藏自治区乃东县人民法院	西藏
西藏自治区南木林县人民法院	西藏
西藏自治区尼玛县人民法院	西藏
西藏自治区尼木县人民法院	西藏
西藏自治区聂拉木县人民法院	西藏
西藏自治区聂荣县人民法院	西藏
西藏自治区普兰县人民法院	西藏
西藏自治区琼结县人民法院	西藏
西藏自治区曲水县人民法院	西藏
西藏自治区曲松县人民法院	西藏
西藏自治区仁布县人民法院	西藏
西藏自治区日喀则市桑珠孜区人民法院	西藏
西藏自治区日喀则市中级人民法院	西藏
西藏自治区日土县人民法院	西藏
西藏自治区萨嘎县人民法院	西藏
西藏自治区萨迦县人民法院	西藏
西藏自治区桑日县人民法院	西藏
西藏自治区山南地区中级人民法院	西藏
西藏自治区申扎县人民法院	西藏
西藏自治区双湖县人民法院	西藏
西藏自治区索县人民法院	西藏
西藏自治区谢通门县人民法院	西藏
西藏自治区亚东县人民法院	西藏
西藏自治区扎囊县人民法院	西藏
西藏自治区札达县人民法院	西藏
西藏自治区仲巴县人民法院	西藏
西藏自治区左贡县人民法院	西藏
新疆维吾尔自治区阿合奇县人民法院	新疆
新疆维吾尔自治区阿克苏地区中级人民法院	新疆
新疆维吾尔自治区阿克苏垦区人民法院	新疆
新疆维吾尔自治区阿克苏市人民法院	新疆
新疆维吾尔自治区阿克陶县人民法院	新疆
新疆维吾尔自治区阿拉尔垦区人民法院	新疆
新疆维吾尔自治区阿拉尔市人民法院	新疆
新疆维吾尔自治区阿拉山口市人民法院	新疆
新疆维吾尔自治区阿勒泰地区中级人民法院	新疆
新疆维吾尔自治区阿勒泰市人民法院	新疆
新疆维吾尔自治区阿图什市人民法院	新疆
新疆维吾尔自治区阿瓦提县人民法院	新疆
新疆维吾尔自治区巴楚县人民法院	新疆
新疆维吾尔自治区巴里巴盖垦区人民法院	新疆
新疆维吾尔自治区巴里坤哈萨克自治县人民法院	新疆
新疆维吾尔自治区巴里坤垦区人民法院	新疆
新疆维吾尔自治区巴音郭楞蒙古自治州中级人民法院	新疆
新疆维吾尔自治区拜城县人民法院	新疆
新疆维吾尔自治区北屯垦区人民法院	新疆
新疆维吾尔自治区北屯市人民法院	新疆
新疆维吾尔自治区博尔塔拉蒙古自治州中级人民法院	新疆
新疆维吾尔自治区博湖县人民法院	新疆
新疆维吾尔自治区博乐垦区人民法院	新疆
新疆维吾尔自治区博乐市人民法院	新疆
新疆维吾尔自治区布尔津县人民法院	新疆
新疆维吾尔自治区策勒县人民法院	新疆
新疆维吾尔自治区察布查尔锡伯自治县人民法院	新疆
新疆维吾尔自治区昌吉回族自治州中级人民法院	新疆
新疆维吾尔自治区昌吉市人民法院	新疆
新疆维吾尔自治区车排子垦区人民法院	新疆
新疆维吾尔自治区额敏垦区人民法院	新疆
新疆维吾尔自治区额敏县人民法院	新疆
新疆维吾尔自治区芳草湖垦区人民法院	新疆
新疆维吾尔自治区福海县人民法院	新疆
新疆维吾尔自治区阜康市人民法院	新疆
新疆维吾尔自治区富蕴县人民法院	新疆
新疆维吾尔自治区伽师县人民法院	新疆
新疆维吾尔自治区高级人民法院	新疆
新疆维吾尔自治区巩留县人民法院	新疆
新疆维吾尔自治区哈巴河县人民法院	新疆
新疆维吾尔自治区哈密地区中级人民法院	新疆
新疆维吾尔自治区哈密垦区人民法院	新疆
新疆维吾尔自治区哈密市人民法院	新疆
新疆维吾尔自治区哈密铁路运输法院	新疆
新疆维吾尔自治区和布克赛尔蒙古自治县人民法院	新疆
新疆维吾尔自治区和静县人民法院	新疆
新疆维吾尔自治区和硕县人民法院	新疆
新疆维吾尔自治区和田地区中级人民法院	新疆
新疆维吾尔自治区和田垦区人民法院	新疆
新疆维吾尔自治区和田市人民法院	新疆
新疆维吾尔自治区和田县人民法院	新疆
新疆维吾尔自治区呼图壁县人民法院	新疆
新疆维吾尔自治区霍城垦区人民法院	新疆
新疆维吾尔自治区霍城县人民法院	新疆
新疆维吾尔自治区霍尔果斯市人民法院	新疆
新疆维吾尔自治区吉木乃县人民法院	新疆
新疆维吾尔自治区吉木萨尔县人民法院	新疆
新疆维吾尔自治区金银川垦区人民法院	新疆
新疆维吾尔自治区精河县人民法院	新疆
新疆维吾尔自治区喀什地区中级人民法院	新疆
新疆维吾尔自治区喀什垦区人民法院	新疆
新疆维吾尔自治区喀什市人民法院	新疆
新疆维吾尔自治区柯坪县人民法院	新疆
新疆维吾尔自治区可克达拉市人民法院	新疆
新疆维吾尔自治区克拉玛依市白碱滩区人民法院	新疆
新疆维吾尔自治区克拉玛依市独山子区人民法院	新疆
新疆维吾尔自治区克拉玛依市克拉玛依区人民法院	新疆
新疆维吾尔自治区克拉玛依市乌尔禾区人民法院	新疆
新疆维吾尔自治区克拉玛依市中级人民法院	新疆
新疆维吾尔自治区克孜勒苏柯尔克孜自治州中级人民法院	新疆
新疆维吾尔自治区库车县人民法院	新疆
新疆维吾尔自治区库尔勒垦区人民法院	新疆
新疆维吾尔自治区库尔勒市人民法院	新疆
新疆维吾尔自治区库尔勒铁路运输法院	新疆
新疆维吾尔自治区奎屯垦区人民法院	新疆
新疆维吾尔自治区奎屯市人民法院	新疆
新疆维吾尔自治区轮台县人民法院	新疆
新疆维吾尔自治区洛浦县人民法院	新疆
新疆维吾尔自治区玛纳斯县人民法院	新疆
新疆维吾尔自治区麦盖提县人民法院	新疆
新疆维吾尔自治区民丰县人民法院	新疆
新疆维吾尔自治区莫索湾垦区人民法院	新疆
新疆维吾尔自治区墨玉县人民法院	新疆
新疆维吾尔自治区木垒哈萨克自治县人民法院	新疆
新疆维吾尔自治区尼勒克县人民法院	新疆
新疆维吾尔自治区皮山县人民法院	新疆
新疆维吾尔自治区奇台垦区人民法院	新疆
新疆维吾尔自治区奇台县人民法院	新疆
新疆维吾尔自治区且末县人民法院	新疆
新疆维吾尔自治区青河县人民法院	新疆
新疆维吾尔自治区若羌县人民法院	新疆
新疆维吾尔自治区三坪垦区人民法院	新疆
新疆维吾尔自治区沙湾县人民法院	新疆
新疆维吾尔自治区沙雅县人民法院	新疆
新疆维吾尔自治区莎车县人民法院	新疆
新疆维吾尔自治区鄯善县人民法院	新疆
新疆维吾尔自治区石河子市人民法院	新疆
新疆维吾尔自治区疏附县人民法院	新疆
新疆维吾尔自治区疏勒县人民法院	新疆
新疆维吾尔自治区双河市人民法院	新疆
新疆维吾尔自治区塔城地区中级人民法院	新疆
新疆维吾尔自治区塔城市人民法院	新疆
新疆维吾尔自治区塔什库尔干塔吉克自治县人民法院	新疆
新疆维吾尔自治区塔斯海垦区人民法院	新疆
新疆维吾尔自治区特克斯县人民法院	新疆
新疆维吾尔自治区铁门关市人民法院	新疆
新疆维吾尔自治区图木舒克垦区人民法院	新疆
新疆维吾尔自治区图木舒克市人民法院	新疆
新疆维吾尔自治区吐鲁番市高昌区人民法院	新疆
新疆维吾尔自治区吐鲁番市中级人民法院	新疆
新疆维吾尔自治区托克逊县人民法院	新疆
新疆维吾尔自治区托里县人民法院	新疆
新疆维吾尔自治区尉犁县人民法院	新疆
新疆维吾尔自治区温泉县人民法院	新疆
新疆维吾尔自治区温宿县人民法院	新疆
新疆维吾尔自治区乌鲁克垦区人民法院	新疆
新疆维吾尔自治区乌鲁木齐垦区人民法院	新疆
新疆维吾尔自治区乌鲁木齐市达坂城区人民法院	新疆
新疆维吾尔自治区乌鲁木齐市米东区人民法院	新疆
新疆维吾尔自治区乌鲁木齐市沙依巴克区人民法院	新疆
新疆维吾尔自治区乌鲁木齐市水磨沟区人民法院	新疆
新疆维吾尔自治区乌鲁木齐市天山区人民法院	新疆
新疆维吾尔自治区乌鲁木齐市头屯河区人民法院	新疆
新疆维吾尔自治区乌鲁木齐市新市区人民法院	新疆
新疆维吾尔自治区乌鲁木齐市中级人民法院	新疆
新疆维吾尔自治区乌鲁木齐铁路运输法院	新疆
新疆维吾尔自治区乌鲁木齐铁路运输中级法院	新疆
新疆维吾尔自治区乌鲁木齐县人民法院	新疆
新疆维吾尔自治区乌恰县人民法院	新疆
新疆维吾尔自治区乌什县人民法院	新疆
新疆维吾尔自治区乌苏市人民法院	新疆
新疆维吾尔自治区五家渠垦区人民法院	新疆
新疆维吾尔自治区五家渠市人民法院	新疆
新疆维吾尔自治区下野地垦区人民法院	新疆
新疆维吾尔自治区新和县人民法院	新疆
新疆维吾尔自治区新疆生产建设兵团第八师中级人民法院	新疆
新疆维吾尔自治区新疆生产建设兵团第二师中级人民法院	新疆
新疆维吾尔自治区新疆生产建设兵团第九师中级人民法院	新疆
新疆维吾尔自治区新疆生产建设兵团第六师中级人民法院	新疆
新疆维吾尔自治区新疆生产建设兵团第七师中级人民法院	新疆
新疆维吾尔自治区新疆生产建设兵团第三师中级人民法院	新疆
新疆维吾尔自治区新疆生产建设兵团第十二师中级人民法院	新疆
新疆维吾尔自治区新疆生产建设兵团第十三师中级人民法院	新疆
新疆维吾尔自治区新疆生产建设兵团第十师中级人民法院	新疆
新疆维吾尔自治区新疆生产建设兵团第十四师中级人民法院	新疆
新疆维吾尔自治区新疆生产建设兵团第四师中级人民法院	新疆
新疆维吾尔自治区新疆生产建设兵团第五师中级人民法院	新疆
新疆维吾尔自治区新疆生产建设兵团第一师中级人民法院	新疆
新疆维吾尔自治区新疆维吾尔自治区高级人民法院生产建设兵团分院	新疆
新疆维吾尔自治区高级人民法院伊犁哈萨克自治州分院	新疆
新疆维吾尔自治区新源县人民法院	新疆
新疆维吾尔自治区焉耆回族自治县人民法院	新疆
新疆维吾尔自治区焉耆垦区人民法院	新疆
新疆维吾尔自治区叶城县人民法院	新疆
新疆维吾尔自治区叶尔盖提垦区人民法院	新疆
新疆维吾尔自治区伊宁垦区人民法院	新疆
新疆维吾尔自治区伊宁市人民法院	新疆
新疆维吾尔自治区伊宁县人民法院	新疆
新疆维吾尔自治区伊吾县人民法院	新疆
新疆维吾尔自治区英吉沙县人民法院	新疆
新疆维吾尔自治区于田县人民法院	新疆
新疆维吾尔自治区裕民县人民法院	新疆
新疆维吾尔自治区岳普湖县人民法院	新疆
新疆维吾尔自治区泽普县人民法院	新疆
新疆维吾尔自治区昭苏垦区人民法院	新疆
新疆维吾尔自治区昭苏县人民法院	新疆
云南省安宁市人民法院	云南
云南省保山市隆阳区人民法院	云南
云南省保山市中级人民法院	云南
云南省宾川县人民法院	云南
云南省沧源佤族自治县人民法院	云南
云南省昌宁县人民法院	云南
云南省澄江县人民法院	云南
云南省楚雄市人民法院	云南
云南省楚雄彝族自治州中级人民法院	云南
云南省大关县人民法院	云南
云南省大理白族自治州中级人民法院	云南
云南省大理市人民法院	云南
云南省大姚县人民法院	云南
云南省德宏傣族景颇族自治州中级人民法院	云南
云南省德钦县人民法院	云南
云南省迪庆藏族自治州中级人民法院	云南
云南省峨山彝族自治县人民法院	云南
云南省洱源县人民法院	云南
云南省凤庆县人民法院	云南
云南省福贡县人民法院	云南
云南省富民县人民法院	云南
云南省富宁县人民法院	云南
云南省富源县人民法院	云南
云南省高级人民法院	云南
云南省个旧市人民法院	云南
云南省耿马傣族佤族自治县人民法院	云南
云南省贡山独龙族怒族自治县人民法院	云南
云南省广南县人民法院	云南
云南省河口瑶族自治县人民法院	云南
云南省鹤庆县人民法院	云南
云南省红河哈尼族彝族自治州中级人民法院	云南
云南省红河县人民法院	云南
云南省华宁县人民法院	云南
云南省华坪县人民法院	云南
云南省会泽县人民法院	云南
云南省建水县人民法院	云南
云南省剑川县人民法院	云南
云南省江城哈尼族彝族自治县人民法院	云南
云南省江川县人民法院	云南
云南省金平苗族瑶族傣族自治县人民法院	云南
云南省晋宁县人民法院	云南
云南省景东彝族自治县人民法院	云南
云南省景谷傣族彝族自治县人民法院	云南
云南省景洪市人民法院	云南
云南省开远市人民法院	云南
云南省开远铁路运输法院	云南
云南省昆明市呈贡区人民法院	云南
云南省昆明市东川区人民法院	云南
云南省昆明市官渡区人民法院	云南
云南省昆明市盘龙区人民法院	云南
云南省昆明市五华区人民法院	云南
云南省昆明市西山区人民法院	云南
云南省昆明市中级人民法院	云南
云南省昆明铁路运输法院	云南
云南省昆明铁路运输中级法院	云南
云南省兰坪白族普米族自治县人民法院	云南
云南省澜沧拉祜族自治县人民法院	云南
云南省丽江市古城区人民法院	云南
云南省丽江市中级人民法院	云南
云南省梁河县人民法院	云南
云南省临沧市临翔区人民法院	云南
云南省临沧市中级人民法院	云南
云南省龙陵县人民法院	云南
云南省陇川县人民法院	云南
云南省泸水县人民法院	云南
云南省泸西县人民法院	云南
云南省鲁甸县人民法院	云南
云南省陆良县人民法院	云南
云南省禄丰县人民法院	云南
云南省禄劝彝族苗族自治县人民法院	云南
云南省罗平县人民法院	云南
云南省绿春县人民法院	云南
云南省麻栗坡县人民法院	云南
云南省马关县人民法院	云南
云南省马龙县人民法院	云南
云南省芒市人民法院	云南
云南省蒙自市人民法院	云南
云南省勐海县人民法院	云南
云南省勐腊县人民法院	云南
云南省孟连傣族拉祜族佤族自治县人民法院	云南
云南省弥渡县人民法院	云南
云南省弥勒市人民法院	云南
云南省墨江哈尼族自治县人民法院	云南
云南省牟定县人民法院	云南
云南省南华县人民法院	云南
云南省南涧彝族自治县人民法院	云南
云南省宁洱哈尼族彝族自治县人民法院	云南
云南省宁蒗彝族自治县人民法院	云南
云南省怒江傈僳族自治州中级人民法院	云南
云南省屏边苗族自治县人民法院	云南
云南省普洱市思茅区人民法院	云南
云南省普洱市中级人民法院	云南
云南省巧家县人民法院	云南
云南省丘北县人民法院	云南
云南省曲靖市麒麟区人民法院	云南
云南省曲靖市中级人民法院	云南
云南省瑞丽市人民法院	云南
云南省师宗县人民法院	云南
云南省施甸县人民法院	云南
云南省石林彝族自治县人民法院	云南
云南省石屏县人民法院	云南
云南省双柏县人民法院	云南
云南省双江拉祜族佤族布朗族傣族自治县人民法院	云南
云南省水富县人民法院	云南
云南省嵩明县人民法院	云南
云南省绥江县人民法院	云南
云南省腾冲市人民法院	云南
云南省通海县人民法院	云南
云南省威信县人民法院	云南
云南省巍山彝族回族自治县人民法院	云南
云南省维西傈僳族自治县人民法院	云南
云南省文山市人民法院	云南
云南省文山壮族苗族自治州中级人民法院	云南
云南省武定县人民法院	云南
云南省西畴县人民法院	云南
云南省西盟佤族自治县人民法院	云南
云南省西双版纳傣族自治州中级人民法院	云南
云南省香格里拉市人民法院	云南
云南省祥云县人民法院	云南
云南省新平彝族傣族自治县人民法院	云南
云南省宣威市人民法院	云南
云南省寻甸回族彝族自治县人民法院	云南
云南省盐津县人民法院	云南
云南省砚山县人民法院	云南
云南省漾濞彝族自治县人民法院	云南
云南省姚安县人民法院	云南
云南省宜良县人民法院	云南
云南省彝良县人民法院	云南
云南省易门县人民法院	云南
云南省盈江县人民法院	云南
云南省永德县人民法院	云南
云南省永平县人民法院	云南
云南省永仁县人民法院	云南
云南省永善县人民法院	云南
云南省永胜县人民法院	云南
云南省玉龙纳西族自治县人民法院	云南
云南省玉溪市红塔区人民法院	云南
云南省玉溪市中级人民法院	云南
云南省元江哈尼族彝族傣族自治县人民法院	云南
云南省元谋县人民法院	云南
云南省元阳县人民法院	云南
云南省云龙县人民法院	云南
云南省云县人民法院	云南
云南省沾益县人民法院	云南
云南省昭通市昭阳区人民法院	云南
云南省昭通市中级人民法院	云南
云南省镇康县人民法院	云南
云南省镇雄县人民法院	云南
云南省镇沅彝族哈尼族拉祜族自治县人民法院	云南
浙江省安吉县人民法院	浙江
浙江省苍南县人民法院	浙江
浙江省常山县人民法院	浙江
浙江省淳安县人民法院	浙江
浙江省慈溪市人民法院	浙江
浙江省岱山县人民法院	浙江
浙江省德清县人民法院	浙江
浙江省东阳市人民法院	浙江
浙江省奉化市人民法院	浙江
浙江省高级人民法院	浙江
浙江省海宁市人民法院	浙江
浙江省海盐县人民法院	浙江
浙江省杭州经济技术开发区人民法院	浙江
浙江省杭州市滨江区人民法院	浙江
浙江省杭州市富阳区人民法院	浙江
浙江省杭州市拱墅区人民法院	浙江
浙江省杭州市江干区人民法院	浙江
浙江省杭州市上城区人民法院	浙江
浙江省杭州市西湖区人民法院	浙江
浙江省杭州市下城区人民法院	浙江
浙江省杭州市萧山区人民法院	浙江
浙江省杭州市余杭区人民法院	浙江
浙江省杭州市中级人民法院	浙江
浙江省杭州铁路运输法院	浙江
浙江省湖州市南浔区人民法院	浙江
浙江省湖州市吴兴区人民法院	浙江
浙江省湖州市中级人民法院	浙江
浙江省嘉善县人民法院	浙江
浙江省嘉兴市南湖区人民法院	浙江
浙江省嘉兴市秀洲区人民法院	浙江
浙江省嘉兴市中级人民法院	浙江
浙江省建德市人民法院	浙江
浙江省江山市人民法院	浙江
浙江省金华市金东区人民法院	浙江
浙江省金华市婺城区人民法院	浙江
浙江省金华市中级人民法院	浙江
浙江省缙云县人民法院	浙江
浙江省景宁畲族自治县人民法院	浙江
浙江省开化县人民法院	浙江
浙江省兰溪市人民法院	浙江
浙江省乐清市人民法院	浙江
浙江省丽水市莲都区人民法院	浙江
浙江省丽水市中级人民法院	浙江
浙江省临安市人民法院	浙江
浙江省临海市人民法院	浙江
浙江省龙泉市人民法院	浙江
浙江省龙游县人民法院	浙江
浙江省宁波海事法院	浙江
浙江省宁波市北仑区人民法院	浙江
浙江省宁波市海曙区人民法院	浙江
浙江省宁波市江北区人民法院	浙江
浙江省宁波市江东区人民法院	浙江
浙江省宁波市鄞州区人民法院	浙江
浙江省宁波市镇海区人民法院	浙江
浙江省宁波市中级人民法院	浙江
浙江省宁海县人民法院	浙江
浙江省磐安县人民法院	浙江
浙江省平湖市人民法院	浙江
浙江省平阳县人民法院	浙江
浙江省浦江县人民法院	浙江
浙江省青田县人民法院	浙江
浙江省庆元县人民法院	浙江
浙江省衢州市柯城区人民法院	浙江
浙江省衢州市衢江区人民法院	浙江
浙江省衢州市中级人民法院	浙江
浙江省瑞安市人民法院	浙江
浙江省三门县人民法院	浙江
浙江省绍兴市柯桥区人民法院	浙江
浙江省绍兴市上虞区人民法院	浙江
浙江省绍兴市越城区人民法院	浙江
浙江省绍兴市中级人民法院	浙江
浙江省嵊泗县人民法院	浙江
浙江省嵊州市人民法院	浙江
浙江省松阳县人民法院	浙江
浙江省遂昌县人民法院	浙江
浙江省台州市黄岩区人民法院	浙江
浙江省台州市椒江区人民法院	浙江
浙江省台州市路桥区人民法院	浙江
浙江省台州市中级人民法院	浙江
浙江省泰顺县人民法院	浙江
浙江省天台县人民法院	浙江
浙江省桐庐县人民法院	浙江
浙江省桐乡市人民法院	浙江
浙江省温岭市人民法院	浙江
浙江省温州市洞头区人民法院	浙江
浙江省温州市龙湾区人民法院	浙江
浙江省温州市鹿城区人民法院	浙江
浙江省温州市瓯海区人民法院	浙江
浙江省温州市中级人民法院	浙江
浙江省文成县人民法院	浙江
浙江省武义县人民法院	浙江
浙江省仙居县人民法院	浙江
浙江省象山县人民法院	浙江
浙江省新昌县人民法院	浙江
浙江省义乌市人民法院	浙江
浙江省永嘉县人民法院	浙江
浙江省永康市人民法院	浙江
浙江省余姚市人民法院	浙江
浙江省玉环县人民法院	浙江
浙江省云和县人民法院	浙江
浙江省长兴县人民法院	浙江
浙江省舟山市定海区人民法院	浙江
浙江省舟山市普陀区人民法院	浙江
浙江省舟山市中级人民法院	浙江
浙江省诸暨市人民法院	浙江
中国人民解放军北京军区河北军事法院	河北
中国人民解放军北京军区军事法院	北京
中国人民解放军北京军区空军军事法院	北京
中国人民解放军北京军区内蒙古军事法院	内蒙古
中国人民解放军北京军区山西军事法院	山西
中国人民解放军北京军区天津军事法院	天津
中国人民解放军北京军区直属军事法院	北京
中国人民解放军成都军区军事法院	四川
中国人民解放军成都军区空军军事法院	四川
中国人民解放军成都军区西藏军事法院	西藏
中国人民解放军成都军区云南军事法院	云南
中国人民解放军成都军区直属军事法院	四川
中国人民解放军成都军区重庆军事法院	重庆
中国人民解放军第二炮兵军事法院	中国
中国人民解放军第二炮兵直属军事法院	中国
中国人民解放军广州军区广西军事法院	广西
中国人民解放军广州军区海南军事法院	海南
中国人民解放军广州军区湖北军事法院	湖北
中国人民解放军广州军区湖南军事法院	湖南
中国人民解放军广州军区军事法院	广东
中国人民解放军广州军区空军军事法院	广东
中国人民解放军广州军区直属军事法院	广东
中国人民解放军海军北海舰队军事法院	中国
中国人民解放军海军东海舰队军事法院	中国
中国人民解放军海军军事法院	中国
中国人民解放军海军南海舰队军事法院	中国
中国人民解放军海军直属军事法院	中国
中国人民解放军济南军区河南军事法院	河南
中国人民解放军济南军区军事法院	山东
中国人民解放军济南军区空军军事法院	山东
中国人民解放军济南军区直属军事法院	山东
中国人民解放军军事法院	中国
中国人民解放军空军军事法院	中国
中国人民解放军空军直属军事法院	中国
中国人民解放军兰州军区军事法院	甘肃
中国人民解放军兰州军区空军军事法院	甘肃
中国人民解放军兰州军区青海军事法院	青海
中国人民解放军兰州军区陕西军事法院	陕西
中国人民解放军兰州军区新疆军事法院	新疆
中国人民解放军兰州军区新疆军事法院南疆分院	新疆
中国人民解放军兰州军区直属军事法院	甘肃
中国人民解放军南京军区安徽军事法院	安徽
中国人民解放军南京军区福建军事法院	福建
中国人民解放军南京军区军事法院	江苏
中国人民解放军南京军区空军军事法院	江苏
中国人民解放军南京军区上海军事法院	上海
中国人民解放军南京军区浙江军事法院	浙江
中国人民解放军南京军区直属军事法院	江苏
中国人民解放军沈阳军区黑龙江军事法院	黑龙江
中国人民解放军沈阳军区吉林军事法院	吉林
中国人民解放军沈阳军区军事法院	辽宁
中国人民解放军沈阳军区空军军事法院	辽宁
中国人民解放军沈阳军区直属军事法院	辽宁
中国人民解放军驻香港部队军事法院	中国
中国人民解放军总直属队军事法院	中国
中国人民解放军总装备部第二十试验训练基地军事法院	中国
中国人民解放军总装备部第二十一试验训练基地军事法院	中国
中国人民武装警察部队北京军事法院	北京
中国人民武装警察部队成都军事法院	四川
中国人民武装警察部队广州军事法院	广东
中国人民武装警察部队济南军事法院	山东
中国人民武装警察部队军事法院	中国
中国人民武装警察部队拉萨军事法院	西藏
中国人民武装警察部队上海军事法院	上海
中国人民武装警察部队沈阳军事法院	辽宁
中国人民武装警察部队乌鲁木齐军事法院	新疆
中国人民武装警察部队西安军事法院	陕西
重庆市忠县人民法院	重庆
重庆市城口县人民法院	重庆
重庆市垫江县人民法院	重庆
重庆市丰都县人民法院	重庆
重庆市奉节县人民法院	重庆
重庆市开县人民法院	重庆
重庆市梁平县人民法院	重庆
重庆市彭水苗族土家族自治县人民法院	重庆
重庆市石柱土家族自治县人民法院	重庆
重庆市巫山县人民法院	重庆
重庆市巫溪县人民法院	重庆
重庆市武隆县人民法院	重庆
重庆市秀山土家族苗族自治县人民法院	重庆
重庆市酉阳土家族苗族自治县人民法院	重庆
重庆市云阳县人民法院	重庆
重庆市巴南区人民法院	重庆
重庆市北碚区人民法院	重庆
重庆市璧山区人民法院	重庆
重庆市大渡口区人民法院	重庆
重庆市大足区人民法院	重庆
重庆市第二中级人民法院	重庆
重庆市第三中级人民法院	重庆
重庆市第四中级人民法院	重庆
重庆市第五中级人民法院	重庆
重庆市第一中级人民法院	重庆
重庆市涪陵区人民法院	重庆
重庆市高级人民法院	重庆
重庆市合川区人民法院	重庆
重庆市江北区人民法院	重庆
重庆市江津区人民法院	重庆
重庆市九龙坡区人民法院	重庆
重庆市南岸区人民法院	重庆
重庆市南川区人民法院	重庆
重庆市綦江区人民法院	重庆
重庆市黔江区人民法院	重庆
重庆市荣昌区人民法院	重庆
重庆市沙坪坝区人民法院	重庆
重庆市铜梁区人民法院	重庆
重庆市潼南区人民法院	重庆
重庆市万州区人民法院	重庆
重庆市永川区人民法院	重庆
重庆市渝北区人民法院	重庆
重庆市渝中区人民法院	重庆
重庆市长寿区人民法院	重庆
重庆市重庆市荣昌区人民法院	重庆
重庆市重庆市潼南区人民法院	重庆
重庆铁路运输法院	重庆
重庆市璧山县人民法院	重庆
山东省沾化县人民法院	山东
北京市密云县人民法院	北京
浙江省富阳市人民法院	浙江
福建省永定县人民法院	福建
山东省淄博高新技术产业开发区人民法院	山东
河南省安阳市文锋区人民法院	河南
山东省济南市人民法院	山东
贵州省铜仁市万山区法院	贵州
河南省三门峡市陕州区人民法院	河南
西藏自治区山南市乃东区人民法院)	西藏
河北省保定市北市区人民法院	河北
河北省保定市南市区人民法院	河北
河北省保定市新市区人民法院	河北
河南省偃师市民法院 	河南
贵州省六盘水六枝特区人民法院	贵州
贵州省六盘水钟山区人民法院	贵州
黑龙江省哈尔滨市双城市人民法院	黑龙江
黑龙江省双鸭山人市四方台区民法院	黑龙江
新疆维吾尔自治区吐鲁番地区中级人民法院	新疆
山东省东营市垦利县人民法院	山东
广州市萝岗区人民法院	广东
贵州省凤冈县人民法院	贵州
黑龙江省哈尔滨市双城市区人民法院	黑龙江
山东省东营市垦利区人民法院	山东
西藏自治区拉萨市堆龙德庆县人民法院	西藏
云南省墨江县人民法院	云南
天津市宁河县人民法院	天津
贵州省平坝县人民法院	贵州
青海省海东市平安县人民法院	青海
山东省庆云人民法院	山东
北京市延庆县人民法院	北京
河北省张家口中级人民法院	河北
四川省成都市双流区人民法院	四川
江西省南昌市新建县人民法院	江西
云南省昆明市晋宁区人民法院	云南
浙江省景宁县人民法院	浙江
云南省曲靖市沾益区人民法院	云南
浙江省杭州市余杭区人民院	浙江
西藏自治区林芝市中级人民法院	西藏
浙江省温州市洞头县人民法院	浙江
山东省济南市区人民法院	山东
山东省济南市济南市人民法院	山东
山东省淄博市高新技术产业开发区人民法院	山东
河北省保定市清苑县人民法院	河北
河北省保定市 满城县人民法院	河北
重庆市潼南县人民法院	重庆
河南省焦作市山阳区人民院	河南
云南省玉溪市江川区人民法院	云南
云南省玉溪市江川县人民法院	云南
河北省石家庄市桥东区人民法院	河北
云南省红河州中级人民法院	云南
浙江省绍兴县人民法院	浙江
浙江省绍兴市柯区人民法院	浙江
四川省绵阳市安州区人民法院	四川
云南省腾冲县人民法院	云南
重庆市荣昌县人民法院	重庆
山东省莱芜市钢城人民法院	山东
湖北省襄阳市某城区人民法院	湖北
湖北省襄阳市樊城人民法院	湖北
湖北省襄阳市襄城区某法院	湖北
湖北省襄阳市高新技术产业开发区人民法院	湖北
湖北省襄阳技术产业开发区人民法院	湖北
湖北省襄阳高某技术产业开发区人民法院	湖北
江西省赣县区人民法院	江西
江苏省连云港市新浦区人民法院	江苏
河北省邯郸市涉县人民法院	河北
安徽省铜陵市义安区人民法院	安徽
安徽省铜陵市铜官区人民法院	安徽
天津市静海县人民法院	天津
黑龙江省鹤岗市绥滨县人民法院	黑龙江
黑龙江鹤岗市萝北县人民法院	黑龙江
黑龙江宾县人民法院	黑龙江
黑龙江省加格达奇区人民法院	黑龙江
福建省龙岩市永定区人民法院	福建
贵州省凤冈县人民法院	贵州
西藏自治区堆龙德庆区人民法院	西藏
西藏自治区林芝县人民法院	西藏
